Pos	Qual	Freq	Ref	Base	UngappedCoverage	TotalCoverage	VariantCov	ForwardVariantCov	ReverseVariantCov	RefCov	ForwardRefCov	ReverseRefCov	replica	State	Decision	SB	GATK_SB	Fisher_SB
1070	0	0.09187620889748549	C	T	1034	1035	95	49	46	938	558	380	a	TRUE	1	0.2963768797355945	0.10931788572542735	0.8449999143079351
1129	0	0.03853211009174312	G	A	545	548	21	19	2	522	134	388	a	FALSE	0	3.0784170078287727	0.12851641884772377	0.9999999981786036
1175	0	0.24737945492662475	A	G	477	515	118	105	13	359	55	304	a	TRUE	1	2.4870316593594612	0.8361950036466524	1
1176	0	0.04354354354354354	G	A	666	668	29	29	0	637	178	459	a	FALSE	0	3.2173913043478266	0.1464746433690533	0.9999999999999996
1183	0	0.031088082901554404	C	T	386	390	12	4	8	366	365	1	a	FALSE	0	27.658536585365855	0.9080812119596606	0.9999999999995401
1187	0	0.11406844106463879	T	G	263	351	30	29	1	233	207	26	a	TRUE	1	0.7525685289809584	0.13356584197494942	0.6668687700103993
1229	0	0.24347826086956523	G	A	115	132	28	28	0	85	63	22	a	FALSE	0	1.2417582417582418	0.40904977375565615	0.9983711282013943
1337	0	0.07611297271421733	A	T	2089	2098	159	74	85	1928	992	936	a	TRUE	1	0.18157329888292156	0.08386158581019049	0.7516418030009042
1343	0	0.06802721088435375	C	T	1323	1331	90	41	49	1204	81	1123	a	TRUE	1	4.230757442946219	0.34608594312436597	1
1442	0	0.08354755784061697	C	T	778	780	65	35	30	713	488	225	a	TRUE	1	0.6071446492996374	0.11978136959653009	0.9809433723761452
1457	0	0.033797216699801194	T	C	503	509	17	0	17	486	269	217	a	FALSE	0	2.1495726495726495	0.07519081284513383	0.9999983775124558
1475	0	0.06752873563218391	A	G	696	696	47	4	43	648	292	356	a	TRUE	1	1.3937842017349296	0.11402405956499523	0.9999998358791103
1499	0	0.10185185185185185	G	A	540	547	55	11	44	484	128	356	a	TRUE	1	0.30246043165467634	0.11280575539568345	0.6663494118034747
1517	0	0.053763440860215055	G	T	93	97	5	0	5	88	66	22	a	FALSE	0	3.444444444444444	0.1957070707070707	0.9984466421581318
1522	0	0.16312056737588654	G	T	141	143	23	10	13	118	16	102	a	FALSE	0	1.6648538606950705	0.407629952950513	0.9979909982096083
1586	0	0.1952662721893491	C	T	169	204	33	1	32	135	96	39	a	FALSE	0	2.2420106392808585	0.5550941387154542	0.9999999999998561
1622	0	0.05194805194805195	G	A	385	395	20	15	5	364	24	340	a	FALSE	0	7.1063545150501675	0.39986769083759055	0.9999999999991579
1655	0	0.13399503722084366	C	T	1209	1209	162	87	75	1046	570	476	a	TRUE	1	0.027560752099227846	0.13638116639315165	0.13431405248160588
1664	0	0.09924812030075188	A	G	665	670	66	66	0	596	113	483	a	FALSE	0	3.6983240223463687	0.4095459487833227	1
1665	0	0.06378378378378378	G	A	925	928	59	58	1	863	171	692	a	FALSE	0	3.9354102258402452	0.27020009439415693	1
1736	0	0.07319952774498228	A	G	847	847	62	23	39	785	366	419	a	TRUE	1	0.3555606876090663	0.08644589333532203	0.814730062530842
1756	0	0.03164556962025317	G	A	316	321	10	10	0	306	5	301	a	FALSE	0	21.066666666666663	0.6884531590413943	0.9999999999999988
1768	0	0.030612244897959183	C	A	392	392	12	0	12	380	102	278	a	FALSE	0	1.3517241379310345	0.04268602540834846	0.9583887402996004
1840	0	0.08974358974358974	A	G	156	158	14	14	0	142	10	132	a	FALSE	0	6.5	0.6408450704225352	0.9999999999999383
1895	0	0.03048780487804878	C	T	164	175	5	0	5	158	99	59	a	FALSE	0	2.546875	0.08059731012658228	0.9915404415321374
2648	0	0.17440225035161744	T	G	711	731	124	59	65	587	493	94	a	TRUE	1	1.7311759043637036	0.44223750721469973	0.9999999999999998
2654	0	0.0706713780918728	C	T	566	568	40	40	0	522	509	13	a	TRUE	1	1.02367941712204	0.07844286721241688	0.38626593351693317
2655	0	0.07278481012658228	G	A	316	320	23	22	1	293	212	81	a	FALSE	0	1.1241627466441888	0.10016072331896855	0.9879187199151018
2773	0	0.07378335949764521	A	C	637	641	47	30	17	590	350	240	a	FALSE	0	0.17347418965494696	0.07959819088709705	0.3563760094577145
2811	0	0.048143053645116916	G	C	1454	1459	70	0	70	1381	1054	327	a	FALSE	0	3.6549118387909316	0.18525983252379816	1
2812	0	0.05114503816793893	T	A	1310	1372	67	0	67	1237	1044	193	a	FALSE	0	5.015384615384614	0.2716497730240656	1
2828	0	0.1681329423264907	C	T	1023	1023	172	89	83	850	114	736	a	TRUE	1	2.0028855578173945	0.47371796110132824	1
2842	0	0.2677165354330709	G	T	254	269	68	1	67	184	157	27	a	FALSE	0	2.6179718318784557	0.970001112425204	1
2864	0	0.1415327564894932	A	G	1618	1637	229	98	131	1389	363	1026	a	TRUE	1	0.7020105632781447	0.21959144859593455	0.9999994588231272
3022	0	0.032520325203252036	A	G	246	264	8	7	1	238	38	200	a	FALSE	0	4.6303482587064675	0.1599843917666569	0.9999685092952878
3038	0	0.100169779286927	T	C	1178	1178	118	79	39	1059	612	447	a	TRUE	1	0.33993504202690933	0.11686939626380444	0.9389258062314829
3050	0	0.08061224489795918	T	C	980	983	79	59	20	900	459	441	a	TRUE	1	0.8738586958884056	0.11852230755701472	0.9999487357596496
4082	0	0.1532567049808429	G	T	261	262	40	38	2	221	60	161	a	FALSE	0	2.450040691123075	0.4523181618093202	0.9999999999999999
4085	0	0.09457092819614711	T	C	1142	1142	108	74	34	1033	495	538	a	TRUE	1	0.7460044430606821	0.1351110979235251	0.999954018700355
4093	0	0.041666666666666664	T	C	96	97	4	4	0	92	86	6	a	FALSE	0	1.0666666666666669	0.0463768115942029	0
4094	0	0.5030674846625767	C	T	163	166	82	59	23	81	80	1	a	TRUE	1	1.0612351582148916	1.1099268733161618	0.9999994309267859
4105	0	0.057569296375266525	G	A	469	469	27	2	25	442	118	324	a	FALSE	0	0.9547896989635289	0.07474220677911896	0.9768406810613571
4106	0	0.10894941634241245	A	G	514	514	56	3	53	458	87	371	a	TRUE	1	0.8413690476190476	0.13560771470160116	0.9914382758069045
4113	0	0.05410122164048865	A	G	573	577	31	31	0	542	191	351	a	FALSE	0	2.581081081081081	0.14762640869651938	0.9999999999999565
4153	0	0.03305785123966942	T	C	605	607	20	1	19	585	315	270	a	FALSE	0	1.8930264771582495	0.0677764375697011	0.9999917547893741
4210	0	0.04417670682730924	G	A	249	257	11	10	1	237	52	185	a	FALSE	0	3.515151515151515	0.16786897146227484	0.9999953033409749
4213	0	0.030864197530864196	G	T	162	164	5	5	0	153	6	147	a	FALSE	0	14.363636363636362	0.46939988116458703	0.9999993998090192
4214	0	0.041666666666666664	T	A	24	42	1	0	1	23	21	2	a	FALSE	0	8	0.34782608695652173	0.8749999999999999
4230	0	0.030303030303030304	C	G	231	232	7	0	7	223	122	101	a	FALSE	0	2.1296296296296293	0.06684936057133367	0.9954740428789545
4234	0	0.08974358974358974	C	T	78	89	7	0	7	67	12	55	a	FALSE	0	1.193548387096774	0.12469908521906596	0.4099259892256669
4235	0	0.030927835051546393	T	C	97	158	3	0	3	92	1	91	a	FALSE	0	1.0106382978723403	0.03295559666975023	0
4238	0	0.19456066945606695	C	T	478	490	93	44	49	385	50	335	a	TRUE	1	1.7499988084343783	0.5069972137791288	0.9999999999949386
4242	0	0.03474903474903475	G	A	259	267	9	9	0	250	5	245	a	FALSE	0	18.5	0.666	0.9999999999998406
4705	0	0.031914893617021274	T	C	564	568	18	0	18	544	479	65	a	FALSE	0	6.771084337349397	0.22404323175053154	0.9999999999999998
4725	0	0.04020100502512563	G	T	199	201	8	8	0	189	17	172	a	FALSE	0	7.880000000000001	0.33354497354497353	0.9999999777989753
4751	0	0.059379217273954114	T	C	741	743	44	29	15	697	471	226	a	TRUE	1	0.0714166352319879	0.06233192639468498	0.13148006505455934
4757	0	0.08088235294117647	T	C	544	551	44	2	42	497	352	145	a	FALSE	0	2.692080095800752	0.24310168087287437	1
4775	0	0.10599078341013825	A	G	217	222	23	1	22	194	41	153	a	FALSE	0	0.961449275362319	0.13727049582719686	0.9453084344604733
4776	0	0.0546448087431694	G	C	366	371	20	0	20	345	111	234	a	FALSE	0	1.4370078740157481	0.083304804290768	0.9992369251714404
4867	0	0.14626865671641792	T	C	335	360	49	0	49	286	252	34	a	FALSE	0	4.036144578313253	0.69150728789283	1
5591	0	0.2118918918918919	T	C	925	932	196	161	35	729	539	190	a	TRUE	1	0.3513321995464853	0.24644109129705838	0.9811221313272916
5633	0	0.037168141592920353	C	T	1130	1130	42	0	42	1088	653	435	a	FALSE	0	2.3689727463312367	0.09144931557528671	0.9999999999999999
5717	0	0.1502546689303905	C	T	1178	1179	177	54	123	999	375	624	a	TRUE	1	0.25768690502200803	0.1694339043736634	0.9242430881984509
5806	0	0.030541871921182268	C	A	2030	2031	62	4	58	1967	1127	840	a	FALSE	0	1.9979523755892452	0.06638816353564034	0.9999999999999999
5817	0	0.047953216374269005	G	A	855	881	41	41	0	814	13	801	a	FALSE	0	15.833333333333334	0.7975020475020476	1
5828	0	0.09728183118741059	T	C	2796	2797	272	233	39	2524	1363	1161	a	TRUE	1	1.166610183547103	0.15646666438282714	1
5871	0	0.03561643835616438	G	A	730	740	26	26	0	703	90	613	a	FALSE	0	6.2844827586206895	0.23242752734585764	1
5906	0	0.030211480362537766	G	A	331	362	10	10	0	314	111	203	a	FALSE	0	2.6776859504132235	0.08527662262462495	0.9999585613615593
6056	0	0.10287081339712918	C	T	836	838	86	26	60	749	341	408	a	TRUE	1	0.5569298686021326	0.13280009014557892	0.9919422507880964
6804	0	0.042643923240938165	C	T	469	471	20	0	20	449	184	265	a	FALSE	0	1.6456140350877193	0.07330129332239284	0.9999397510709126
6890	0	0.14056939501779359	A	G	562	585	79	57	22	483	141	342	a	TRUE	1	1.6179853901372891	0.31471944204863467	0.9999999999994129
6944	0	0.13978494623655913	G	A	372	379	52	48	4	320	0	320	a	FALSE	0	7.065527065527066	1.1481481481481481	1
6985	0	0.07534246575342465	C	A	1168	1170	88	1	87	1080	781	299	a	FALSE	0	2.974548634911992	0.24344189278925507	1
6993	0	0.03930530164533821	G	A	1094	1113	43	43	0	1049	610	439	a	FALSE	0	1.672281776416539	0.06854920532498682	0.9999999998276068
7037	0	0.09095260890378172	C	T	2089	2091	190	129	61	1899	1283	616	a	TRUE	1	0.013813523823409009	0.09144511961010234	0
7094	0	0.14533965244865718	C	T	633	634	92	73	19	539	502	37	a	TRUE	1	1.4563013097488524	0.3467704168059093	0.9998967037653232
7107	0	0.030837004405286344	T	A	454	454	14	1	13	438	257	181	a	FALSE	0	2.0383372720941653	0.06888415956081476	0.9998856338973109
7108	0	0.5042016806722689	A	T	238	238	120	120	0	115	58	57	a	FALSE	0	1.3202247191011236	1.3776257938446508	1
7112	0	0.030373831775700934	C	G	428	433	13	11	2	408	216	192	a	FALSE	0	1.2354365285924396	0.04948667327415093	0.9744435165123327
7148	0	0.16988416988416988	T	C	777	777	132	74	58	644	346	298	a	TRUE	1	0.07800638811874769	0.17771518964205127	0.36682711273587465
7151	0	0.204	C	T	500	501	102	54	48	397	177	220	a	TRUE	1	0.2674138854999259	0.24120133409956335	0.8519140183563112
7155	0	0.04940119760479042	G	A	668	669	33	32	1	632	128	504	a	FALSE	0	3.990399039903991	0.21002631908760497	1
7156	0	0.04375	G	A	480	480	21	21	0	458	140	318	a	FALSE	0	2.975155279503105	0.13641541674577556	0.9999999999545742
7168	0	0.031578947368421054	C	T	760	773	24	1	23	735	658	77	a	FALSE	0	7.225760622154781	0.23714979406026448	1
7175	0	0.13918918918918918	C	T	740	743	103	64	39	637	349	288	a	TRUE	1	0.2564683762401734	0.15855025499001268	0.8007325496779247
7204	0	0.05757575757575758	T	C	330	333	19	1	18	311	187	124	a	FALSE	0	2.1092456192924627	0.1337893269172399	0.9999984220636824
7208	0	0.03827751196172249	A	G	418	427	16	16	0	402	60	342	a	FALSE	0	5.5	0.2189054726368159	0.9999999999996512
7214	0	0.030418250950570342	C	T	526	527	16	0	16	510	382	128	a	FALSE	0	3.6527777777777777	0.11459694989106754	0.9999999994722232
7220	0	0.04390243902439024	A	T	205	206	9	7	2	191	84	107	a	FALSE	0	1.3016545126636871	0.07906978462720814	0.9178832935247757
7234	0	0.06976744186046512	T	G	86	107	6	0	6	80	9	71	a	FALSE	0	1.1168831168831168	0.08376623376623377	0
7240	0	0.08029197080291971	T	C	137	155	11	0	11	126	47	79	a	FALSE	0	1.5222222222222221	0.13289241622574954	0.9840408720865802
7281	0	0.034666666666666665	T	C	375	409	13	13	0	360	106	254	a	FALSE	0	3.134453781512605	0.11318860877684407	0.9999997778960475
7293	0	0.043209876543209874	C	T	1782	1783	77	3	74	1703	1462	241	a	FALSE	0	5.38329453200248	0.24503959625237273	1
7379	0	0.0708502024291498	T	C	988	1020	70	2	68	917	665	252	a	FALSE	0	2.9539711394302848	0.2280355528342699	1
7407	0	0.10071942446043165	C	A	139	149	14	13	1	124	21	103	a	FALSE	0	3.6741273432449897	0.42143026565464897	0.9999999814176823
7447	0	0.06691449814126393	T	A	269	270	18	0	18	250	178	72	a	FALSE	0	2.977777777777778	0.2144	0.9999999991448737
7451	0	0.09608540925266904	C	T	562	570	54	35	19	506	338	168	a	TRUE	1	0.0805829413304576	0.10189605566452276	0.23667620540071366
7455	0	0.03554868624420402	T	C	647	659	23	1	22	624	492	132	a	FALSE	0	3.961573834931273	0.1478222588770256	0.9999999999998948
7493	0	0.099644128113879	G	T	281	281	28	11	17	252	143	109	a	TRUE	1	0.6349206349206349	0.13920382968002015	0.8918996148556394
7505	0	0.11205673758865248	T	C	705	718	79	41	38	626	469	157	a	TRUE	1	1.0216220860301277	0.20182103807362217	0.9999539626563143
7538	0	0.04783258594917788	A	G	669	673	32	18	14	637	176	461	a	TRUE	1	1.3235709441128594	0.0945724796868119	0.9989391783846161
7568	0	0.0920138888888889	T	C	576	603	53	33	20	521	301	220	a	TRUE	1	0.16753285881068058	0.09978220143206867	0.4382325453094278
8007	0	0.08600583090379009	G	A	686	687	59	21	38	625	333	292	a	TRUE	1	0.647243477579588	0.11854594761171033	0.9902468214374672
8048	0	0.1382488479262673	G	A	217	218	30	30	0	187	2	185	a	FALSE	0	6.781249999999999	1.0879010695187166	1
8050	0	0.07344632768361582	G	T	177	177	13	13	0	164	14	150	a	FALSE	0	6.5555555555555545	0.5196476964769647	0.9999999999988278
8097	0	0.04871794871794872	C	T	390	392	19	1	18	370	244	126	a	FALSE	0	2.4756444683136416	0.13088251516822946	0.9999998919419066
8105	0	0.08	C	T	950	950	76	36	40	872	542	330	a	TRUE	1	0.5715987340463757	0.1102101434789286	0.986090572059149
8108	0	0.06369426751592357	A	G	471	481	30	30	0	436	152	284	a	FALSE	0	2.5604395604395607	0.1761770339751991	0.9999999999998836
8124	0	0.0364741641337386	A	G	658	668	24	24	0	634	225	409	a	FALSE	0	2.6425702811244984	0.10003420622553305	0.9999999999638216
8185	0	0.037209302325581395	A	G	215	217	8	0	8	207	121	86	a	FALSE	0	2.2872340425531914	0.08839551855278034	0.9988785100297565
9200	0	0.03282828282828283	G	A	792	795	26	22	4	766	515	251	a	TRUE	1	0.7701306908668064	0.04169445948369283	0.9144013750759212
9225	0	0.112565445026178	C	T	764	765	86	54	32	678	206	472	a	TRUE	1	1.2810347275463556	0.21917728289409708	0.9999999897700903
9242	0	0.07976366322008863	T	C	677	678	54	16	38	619	440	179	a	TRUE	1	1.7451573976757901	0.18371140211778075	0.9999999974819476
9272	0	0.09137577002053388	C	T	974	974	89	33	56	885	445	440	a	TRUE	1	0.4800569001260235	0.11567890022289275	0.9806111196465835
9277	0	0.05234159779614325	C	T	726	727	38	0	38	685	603	82	a	FALSE	0	6.0249999999999995	0.3342335766423358	1
9296	0	0.1265984654731458	T	C	782	783	99	43	56	681	146	535	a	TRUE	1	1.0459766466534657	0.23589592751097552	0.9999925044029883
9818	0	0.13191489361702127	G	A	235	254	31	30	1	204	33	171	a	FALSE	0	3.565757510806273	0.5453634942349033	1
9834	0	0.04332129963898917	G	A	277	282	12	12	0	263	173	90	a	FALSE	0	1.4864864864864864	0.0678244784708663	0.9896483425116063
9887	0	0.04965753424657534	C	T	1168	1168	58	43	15	1110	474	636	a	TRUE	1	1.2109073327921693	0.08550153340819093	0.9999958375340677
9899	0	0.125	A	G	176	192	22	19	3	152	67	85	a	TRUE	1	1.477729194695368	0.24428514799154336	0.9998174659505373
9905	0	0.0380952380952381	G	A	420	425	16	16	0	403	223	180	a	FALSE	0	1.7531380753138073	0.0696034967866524	0.999877668788476
9927	0	0.03293413173652695	G	T	668	669	22	22	0	646	251	395	a	FALSE	0	2.4468864468864466	0.08333049819117931	0.9999999983220038
9928	0	0.0436241610738255	C	T	298	305	13	0	13	283	134	149	a	FALSE	0	1.8271604938271604	0.08393316756096497	0.9996609920439022
9934	0	0.04986149584487535	T	C	361	373	18	0	18	342	132	210	a	FALSE	0	1.5789473684210524	0.08310249307479224	0.9997478198886247
9994	0	0.03878326996197719	T	C	1315	1326	51	0	51	1262	736	526	a	FALSE	0	2.275563258232236	0.09196016336754677	1
10185	0	0.05759162303664921	T	C	191	242	11	0	11	179	12	167	a	FALSE	0	1.0674157303370786	0.06559538007658025	0
10198	0	0.07075471698113207	G	A	212	218	15	4	11	197	22	175	a	FALSE	0	1.3385166804521644	0.1557691258035126	0.905515617895466
10217	0	0.08678237650200267	A	G	749	754	65	33	32	683	393	290	a	TRUE	1	0.2521806423827244	0.10040560377991418	0.7024591918893192
10281	0	0.10549645390070922	G	A	1128	1128	119	64	55	1006	528	478	a	TRUE	1	0.0464995084794225	0.10842102196415343	0.15380044665148618
10286	0	0.12435233160621761	C	T	579	581	72	57	15	505	264	241	a	TRUE	1	0.953463196878245	0.19099910648190987	0.9999875854562346
10314	0	0.05825242718446602	A	G	927	930	54	31	23	873	428	445	a	TRUE	1	0.3157435338807889	0.06819125081034656	0.7372020809411024
10319	0	0.08605341246290801	C	T	674	680	58	3	55	616	572	44	a	FALSE	0	6.3953090121605864	0.6046928916494133	1
10324	0	0.052845528455284556	T	C	492	537	26	0	26	465	357	108	a	FALSE	0	3.6641791044776117	0.20487883164821055	0.9999999999999997
10342	0	0.03324808184143223	A	T	391	393	13	13	0	376	261	115	a	FALSE	0	1.4197080291970803	0.04908564994564373	0.9872670619642256
10349	0	0.13006756756756757	T	C	592	599	77	54	23	514	215	299	a	TRUE	1	0.9925340193529254	0.21432910890188892	0.9999959863740716
10360	0	0.03551401869158879	C	T	535	535	19	3	16	516	214	302	a	FALSE	0	1.0274697699818627	0.051445925272872575	0.9693437067785908
10361	0	0.19083969465648856	T	C	524	550	100	39	61	424	210	214	a	TRUE	1	0.34160438116100766	0.23119717291119884	0.9404649235671855
10376	0	0.09090909090909091	G	A	572	573	52	30	22	520	412	108	a	TRUE	1	1.1149321266968326	0.17351896971806477	0.9991357531689267
10379	0	0.04121475054229935	A	G	461	466	19	0	19	442	197	245	a	FALSE	0	1.746212121212121	0.0750634169751817	0.9999794847929269
1070	0	0.1492094861660079	C	T	1012	1014	151	80	71	861	521	340	b	TRUE	1	0.26565275359348706	0.176018023169098	0.9118518002216812
1083	0	0.03216374269005848	C	A	342	345	11	0	11	324	141	183	b	FALSE	0	1.7268041237113403	0.05862606592847143	0.9968228006365064
1129	0	0.07377049180327869	G	A	488	489	36	35	1	452	86	366	b	FALSE	0	3.884092347803024	0.31144336448590676	1
1175	0	0.3107569721115538	A	G	502	537	156	128	28	346	61	285	b	TRUE	1	1.8914838957437463	0.8946976698920409	1
1176	0	0.049926578560939794	G	A	681	682	34	34	0	647	179	468	b	FALSE	0	3.1971830985915495	0.16801271306354357	1
1187	0	0.14285714285714285	T	G	252	344	36	32	4	213	199	14	b	TRUE	1	0.5788840788840788	0.22379394210380127	0.6939608009650056
1215	0	0.03171247357293869	G	A	473	473	15	15	0	458	66	392	b	FALSE	0	5.839506172839506	0.19125020216723274	0.9999999999989958
1229	0	0.20125786163522014	G	A	159	178	32	32	0	127	101	26	b	FALSE	0	1.1954887218045112	0.3012255047066485	0.9975170215229547
1308	0	0.030303030303030304	G	A	231	240	7	1	6	224	95	129	b	FALSE	0	1.1229166666666668	0.045355902777777776	0.7561082579116981
1337	0	0.08461538461538462	A	T	1950	1959	165	56	109	1781	860	921	b	TRUE	1	0.5270696364587067	0.1085603331158612	0.9995673248966057
1343	0	0.07686453576864535	C	T	1314	1320	101	47	54	1169	72	1097	b	TRUE	1	4.376372943823597	0.4089511278585007	1
1442	0	0.08831168831168831	C	T	770	771	68	43	25	701	466	235	b	TRUE	1	0.13202457573629434	0.09657019689698239	0.4067827326014912
1457	0	0.03822937625754527	T	C	497	499	19	1	18	476	245	231	b	FALSE	0	1.7774177583246982	0.07486906017182071	0.9999424356103227
1475	0	0.05649717514124294	A	G	708	709	40	5	35	667	336	331	b	TRUE	1	1.4310680175632582	0.09987698809601976	0.9999981235601075
1499	0	0.09107806691449814	G	A	538	549	49	13	36	486	130	356	b	TRUE	1	0.010128355609405197	0.09190544904830619	0
1516	0	0.044585987261146494	T	C	157	157	7	0	7	150	126	24	b	FALSE	0	5.064516129032258	0.23634408602150536	0.9999935445360116
1517	0	0.08421052631578947	G	T	95	98	8	0	8	87	66	21	b	FALSE	0	3.2758620689655173	0.30122869599682917	0.9999646885059463
1519	0	0.03187250996015936	G	A	251	251	8	7	1	243	75	168	b	FALSE	0	2.492702770962621	0.08765449916169116	0.9980573877919676
1522	0	0.1888111888111888	G	T	143	147	27	8	19	116	15	101	b	FALSE	0	1.0036097691894794	0.36089455272363824	0.956421221957365
1586	0	0.165	C	T	200	239	33	1	32	166	122	44	b	FALSE	0	2.490048106222689	0.500652159343407	0.9999999999999933
1655	0	0.14494875549048317	C	T	1366	1368	198	122	76	1165	657	508	b	TRUE	1	0.1822431056125466	0.15938342994583174	0.8132165040112496
1664	0	0.09314359637774904	A	G	773	777	72	72	0	696	105	591	b	FALSE	0	4.338983050847458	0.44886031560490947	1
1665	0	0.06660412757973734	G	A	1066	1070	71	71	0	993	174	819	b	FALSE	0	4.3428571428571425	0.31051647245000713	1
1736	0	0.09803921568627451	A	G	1020	1020	100	42	58	920	440	480	b	TRUE	1	0.21083157229017882	0.10910978514043969	0.7076791060816366
1768	0	0.03854389721627409	C	A	467	467	18	0	18	449	143	306	b	FALSE	0	1.441358024691358	0.05778272704776045	0.9973843081051667
1840	0	0.11290322580645161	A	G	186	187	21	21	0	165	17	148	b	FALSE	0	4.894736842105264	0.6229665071770336	1
2630	0	0.03015075376884422	G	A	199	209	6	5	1	192	123	69	b	FALSE	0	0.8176339285714286	0.039707728794642856	0.573356200363196
2648	0	0.17524339360222532	T	G	719	733	126	89	37	590	477	113	b	TRUE	1	0.508148895993419	0.2522745403365874	0.9845990417450471
2654	0	0.09041591320072333	C	T	553	559	50	50	0	500	493	7	b	TRUE	1	1.0128913443830572	0.10128913443830571	0
2655	0	0.059880239520958084	G	A	334	338	20	20	0	314	232	82	b	FALSE	0	1.3253968253968254	0.08442017996158123	0.9945401637443406
2773	0	0.059880239520958084	A	C	668	671	40	22	18	628	362	266	b	FALSE	0	0.1016798708920188	0.06355479613348883	0.25550810449624295
2811	0	0.036036036036036036	G	C	1443	1449	52	1	51	1390	1061	329	b	FALSE	0	3.6956492981693696	0.13910024879293711	1
2812	0	0.04420731707317073	T	A	1312	1386	58	0	58	1251	1045	206	b	FALSE	0	4.958333333333333	0.22988276045830003	1
2828	0	0.18502673796791444	C	T	935	937	173	88	85	761	131	630	b	TRUE	1	1.5275778672722216	0.434545527555806	1
2842	0	0.2736842105263158	G	T	285	296	78	0	78	206	178	28	b	FALSE	0	2.6792452830188673	1.014471514929474	1
2846	0	0.03684210526315789	G	A	380	383	14	3	11	365	6	359	b	FALSE	0	8.21898326898327	0.33582870541774645	0.9970272355003589
2864	0	0.14394904458598726	A	G	1570	1595	226	103	123	1343	376	967	b	TRUE	1	0.7094329205031388	0.22286846318491754	0.9999996923228154
2884	0	0.038922155688622756	G	A	1002	1002	39	35	4	962	232	730	b	FALSE	0	3.2246714767303812	0.1356571187113391	1
3022	0	0.04	A	G	225	238	9	9	0	215	32	183	b	FALSE	0	5.463414634146341	0.2287010777084515	0.9999998946287155
3038	0	0.10278745644599303	T	C	1148	1148	118	83	35	1029	573	456	b	TRUE	1	0.5369641086055826	0.1309801992285805	0.9977252761582777
3050	0	0.0923226433430515	T	C	1029	1031	95	71	24	934	500	434	b	TRUE	1	0.7792401529370425	0.12981204466041804	0.9999196926933787
4082	0	0.11439114391143912	G	T	271	271	31	28	3	240	57	183	b	FALSE	0	2.7386974352696334	0.36596141682479444	0.9999999999995397
4085	0	0.12991452991452992	T	C	1170	1171	152	100	52	1018	502	516	b	TRUE	1	0.5739439698164507	0.17343748147035457	0.9998300082911833
4094	0	0.5681818181818182	C	T	176	182	100	80	20	76	75	1	b	TRUE	1	0.7678033794162825	1.0671840892553965	0.9999195852811769
4105	0	0.056925996204933584	G	A	527	527	30	4	26	497	144	353	b	FALSE	0	0.7303263685849437	0.07077650958880287	0.9081982052708575
4106	0	0.14233576642335766	A	G	548	548	78	8	70	470	94	376	b	TRUE	1	0.5516484160641376	0.1686450364899323	0.9586209670904815
4113	0	0.05509181969949917	A	G	599	599	33	31	2	565	222	343	b	FALSE	0	2.1153351698806246	0.12893443865356138	0.9999999998268838
4153	0	0.030303030303030304	T	C	627	633	19	3	16	608	362	246	b	FALSE	0	1.7440342988601902	0.0624594792429154	0.9998192981442777
4214	0	0.04	T	G	25	52	1	0	1	24	14	10	b	FALSE	0	2.272727272727273	0.09469696969696971	0.56
4234	0	0.10294117647058823	C	T	68	77	7	1	6	58	10	48	b	FALSE	0	0.1875901875901875	0.11320097526994076	0
4238	0	0.23173277661795408	C	T	479	486	111	46	65	365	60	305	b	TRUE	1	1.1076073523804275	0.46651345064371685	0.9999998094495526
4242	0	0.06463878326996197	G	A	263	265	17	17	0	246	2	244	b	FALSE	0	13.842105263157896	0.9565682498930252	1
4706	0	0.0367816091954023	A	G	435	439	16	16	0	419	213	206	b	FALSE	0	1.8995633187772925	0.07253702410605413	0.9999684379677395
4725	0	0.03048780487804878	G	T	164	165	5	5	0	157	15	142	b	FALSE	0	8.1	0.25796178343949044	0.9999822536140954
4726	0	0.08333333333333333	T	G	48	68	4	1	3	44	30	14	b	FALSE	0	1.7305502846299812	0.1863032603070554	0.8794326241134751
4733	0	0.08385481852315395	T	C	799	800	67	33	34	731	494	237	b	TRUE	1	0.7484842046585239	0.12838416897473773	0.9957090043297375
4751	0	0.08345323741007195	T	C	695	697	58	36	22	637	441	196	b	TRUE	1	0.30491007741758347	0.10179624771973743	0.6993996422926292
4757	0	0.06324110671936758	T	C	506	513	32	0	32	472	357	115	b	FALSE	0	3.428571428571429	0.23244552058111378	1
4775	0	0.061224489795918366	A	G	196	200	12	0	12	184	25	159	b	FALSE	0	1.1461988304093567	0.07475209763539283	0.6303779483602291
4776	0	0.05757575757575758	G	C	330	334	19	0	19	309	103	206	b	FALSE	0	1.4577777777777778	0.08963682128730673	0.9986877542931445
4867	0	0.10830324909747292	T	C	277	305	30	1	29	247	226	21	b	FALSE	0	5.314657856093979	0.6475799461377945	1
5591	0	0.17684887459807075	T	C	933	943	165	135	30	768	585	183	b	TRUE	1	0.26381241997439175	0.19570106183978872	0.8741744152415927
5633	0	0.030973451327433628	C	T	1130	1131	35	0	35	1095	670	425	b	FALSE	0	2.456521739130435	0.07851895969823308	0.9999999999999901
5682	0	0.0306030603060306	G	T	1111	1116	34	1	33	1075	874	201	b	FALSE	0	4.562647274294333	0.14531971718204278	1
5717	0	0.14067524115755628	C	T	1244	1244	175	50	125	1067	390	677	b	TRUE	1	0.29966965702626563	0.16080692662142038	0.9589167279017858
5752	0	0.037549407114624504	G	A	1012	1012	38	16	22	974	490	484	b	FALSE	0	0.31578947368421056	0.04374609409874118	0.5912980275317476
5817	0	0.04377880184331797	G	A	868	881	38	34	4	830	17	813	b	FALSE	0	15.116236122742597	0.6937753461827727	1
5828	0	0.11202185792349727	T	C	2928	2929	328	272	56	2597	1405	1192	b	TRUE	1	1.0462457458876913	0.174482322040775	1
5871	0	0.03954802259887006	G	A	708	716	28	28	0	679	103	576	b	FALSE	0	5.396946564885496	0.2225544975210514	1
5906	0	0.034722222222222224	G	A	288	329	10	10	0	275	75	200	b	FALSE	0	3.3529411764705883	0.12192513368983957	0.9999962321792947
6053	0	0.03070175438596491	T	C	456	472	14	0	14	439	236	203	b	FALSE	0	2.0875576036866357	0.06657359100595195	0.9999732599954946
6056	0	0.13088404133180254	C	T	871	875	114	47	67	755	347	408	b	TRUE	1	0.1658973709989642	0.14298394353787114	0.635115198940743
6804	0	0.03070175438596491	C	T	456	457	14	1	13	441	181	260	b	FALSE	0	1.3690476190476188	0.04886081416693662	0.9891777603722304
6839	0	0.03937007874015748	G	A	127	132	5	4	1	119	8	111	b	FALSE	0	8.045238095238094	0.3442376950780312	0.9997502465289544
6840	0	0.03225806451612903	C	A	217	230	7	4	3	209	170	39	b	FALSE	0	1.4947220267417312	0.07212388337615198	0.8646967480935401
6890	0	0.11619718309859155	A	G	568	593	66	36	30	502	161	341	b	TRUE	1	0.8767732602614319	0.19004715059610502	0.9994896092669967
6944	0	0.14285714285714285	G	A	399	406	57	56	1	341	0	341	b	FALSE	0	6.962039601928798	1.1637426900584795	1
6952	0	0.030985915492957747	T	C	355	361	11	1	10	337	283	54	b	FALSE	0	4.831786171574904	0.16078201404271325	0.9999997739416815
6979	0	0.03184713375796178	A	G	157	161	5	1	4	152	1	151	b	FALSE	0	14.889677419354838	0.5031196943972835	0.9371223256573574
6985	0	0.08385933273219116	C	A	1109	1112	93	1	92	1016	712	304	b	FALSE	0	2.753667364806124	0.253233375153619	1
6993	0	0.03955841766329347	G	A	1087	1101	43	42	1	1041	610	431	b	FALSE	0	1.5655572465031735	0.06692274875961515	0.999999992152532
7037	0	0.054011119936457505	C	T	2518	2518	136	94	42	2382	1346	1036	b	TRUE	1	0.48724667897462026	0.0663163056739883	0.9957811845818583
7085	0	0.032692307692307694	A	G	520	529	17	17	0	503	130	373	b	FALSE	0	3.5374149659863945	0.11955478016256205	0.9999999997658956
7094	0	0.11394557823129252	C	T	588	590	67	47	20	521	483	38	b	TRUE	1	2.247988424824479	0.35466053595445424	0.9999994027680539
7108	0	0.45934959349593496	A	T	246	247	113	113	0	130	64	66	b	FALSE	0	1.3728813559322035	1.1933507170795306	1
7110	0	0.036231884057971016	T	C	276	319	10	1	9	264	254	10	b	FALSE	0	12.871496388028897	0.4896988460455952	0.9999999999575155
7113	0	0.044573643410852716	T	C	516	528	23	17	6	491	263	228	b	FALSE	0	0.783811116419812	0.06192863484105846	0.9154578266342615
7148	0	0.10294117647058823	T	C	816	816	84	42	42	731	374	357	b	TRUE	1	0.041735950453055636	0.10551030976367572	0.09163358539557032
7151	0	0.14663951120162932	C	T	491	493	72	32	40	419	169	250	b	TRUE	1	0.14506967080307276	0.16082864420388385	0.48077658325893347
7155	0	0.04878048780487805	G	A	615	615	30	29	1	583	46	537	b	FALSE	0	7.8629087154068555	0.4058080560107635	1
7156	0	0.0787037037037037	G	A	432	434	34	34	0	396	60	336	b	FALSE	0	4.574468085106384	0.39275736084246726	1
7168	0	0.03634085213032581	C	T	798	813	29	0	29	769	665	104	b	FALSE	0	6	0.22626788036410922	1
7175	0	0.07953063885267275	C	T	767	768	61	31	30	706	349	357	b	TRUE	1	0.051044070335961964	0.08175720033333218	0.10587019391297958
7204	0	0.04452054794520548	T	C	292	292	13	3	10	279	142	137	b	FALSE	0	1.063274328298959	0.0697238974690111	0.9147999542355384
7214	0	0.03910614525139665	C	T	537	537	21	2	19	516	372	144	b	FALSE	0	2.8439730605013898	0.12065961029478522	0.9999999923476948
7240	0	0.07407407407407407	T	C	135	153	10	0	10	125	49	76	b	FALSE	0	1.5697674418604652	0.1255813953488372	0.9863536126270439
7281	0	0.030952380952380953	T	C	420	451	13	11	2	406	116	290	b	FALSE	0	2.570882736075272	0.088775290075042	0.9999381473704979
7379	0	0.066795740561471445	T	C	1033	1059	69	1	68	963	670	293	b	FALSE	0	2.795005055361277	0.20156141730832333	1
7407	0	0.12686567164179105	C	A	134	142	17	17	0	113	22	91	b	FALSE	0	3.333333333333333	0.5014749262536873	0.9999999999373873
7415	0	0.04866180048661801	G	A	411	423	20	9	11	391	19	372	b	FALSE	0	6.015148265572548	0.32816609445458284	0.9999991519939503
7447	0	0.09386281588447654	T	A	277	279	26	0	26	249	179	70	b	FALSE	0	2.864583333333333	0.2991131191432396	0.999999999999894
7451	0	0.08900523560209424	C	T	573	577	51	33	18	521	380	141	b	TRUE	1	0.3735316960170701	0.11435817901330646	0.7490822149484406
7455	0	0.039764359351988215	T	C	679	692	27	0	27	652	532	120	b	FALSE	0	4.6190476190476195	0.19127957931638914	1
7493	0	0.09561752988047809	G	T	251	253	24	7	17	227	123	104	b	TRUE	1	0.9062115914388642	0.14698505339274262	0.9699802425636724
7505	0	0.10767160161507403	T	C	743	761	80	34	46	663	510	153	b	TRUE	1	1.5663905464824122	0.2428573864799109	0.9999999992255407
7538	0	0.04783258594917788	A	G	669	671	32	16	16	637	199	438	b	TRUE	1	0.819029812519209	0.07540262509454775	0.9672673881291217
7568	0	0.09491525423728814	T	C	590	617	56	30	26	534	320	214	b	TRUE	1	0.23830782312925172	0.10943463527733191	0.6079682491746288
8007	0	0.08935611038107753	G	A	761	762	68	27	41	693	352	341	b	TRUE	1	0.4038866199203161	0.10946502220038255	0.9018666139203072
8022	0	0.03377110694183865	T	C	533	535	18	0	18	514	419	95	b	FALSE	0	4.707964601769912	0.16487035570400468	0.9999999999997521
8048	0	0.08733624454148471	G	A	229	233	20	19	1	209	3	206	b	FALSE	0	9.833322353974529	0.9417095859783607	1
8050	0	0.045	G	T	200	200	9	9	0	190	19	171	b	FALSE	0	7.107142857142858	0.3366541353383459	0.9999999938471349
8075	0	0.033816425120772944	G	A	621	622	21	21	0	597	127	470	b	FALSE	0	4.175675675675675	0.1468830639684911	0.9999999999999707
8097	0	0.03233256351039261	C	T	433	434	14	1	13	418	264	154	b	FALSE	0	2.285610988266056	0.0801479464110508	0.9999704928621925
8105	0	0.06314797360980208	C	T	1061	1062	67	38	29	994	576	418	b	TRUE	1	0.04731278787402201	0.06496412398708538	0.1015193130281965
8108	0	0.05150976909413854	A	G	563	569	29	28	1	531	169	362	b	FALSE	0	2.6914209967215075	0.14948143439457684	0.9999999999989477
8124	0	0.03117206982543641	A	G	802	814	25	25	0	777	288	489	b	FALSE	0	2.5623003194888176	0.08244209522164793	0.9999999999668243
8139	0	0.032397408207343416	G	A	463	470	15	13	2	447	5	442	b	FALSE	0	22.10570570570571	0.7430954444377263	1
8185	0	0.07581227436823104	A	G	277	279	21	0	21	253	158	95	b	FALSE	0	2.362068965517241	0.19606106037890145	0.9999999953738888
9200	0	0.030751708428246014	G	A	878	878	27	25	2	851	596	255	b	TRUE	1	1.0560567020776173	0.041211689722572165	0.9909508436584772
9225	0	0.08845208845208845	C	T	814	814	72	50	22	742	233	509	b	TRUE	1	1.529044546333081	0.18579213683746076	0.9999999995504634
9242	0	0.06751054852320675	T	C	711	716	48	24	24	660	471	189	b	TRUE	1	0.9468203158344005	0.1150102820781438	0.9969942201875248
9272	0	0.06705539358600583	C	T	1029	1031	69	36	33	960	486	474	b	TRUE	1	0.05781428812221108	0.06911089573556417	0.09909497279844548
9277	0	0.045512010113780026	C	T	791	792	36	0	36	755	675	80	b	FALSE	0	6.81896551724138	0.3251427266499201	1
9296	0	0.10161090458488228	T	C	807	807	82	42	40	724	182	542	b	TRUE	1	1.1674367194702875	0.1943900580964857	0.9999968859849084
9758	0	0.035168195718654434	A	G	654	655	23	1	22	626	155	471	b	TRUE	1	1.0783132189561329	0.04596774769771808	0.9766335240145031
9800	0	0.050724637681159424	C	T	552	553	28	4	24	524	466	58	b	FALSE	0	5.602253688190377	0.3056984514948284	1
9818	0	0.14666666666666667	G	A	225	262	33	32	1	192	22	170	b	FALSE	0	4.0005316321105795	0.6903833658219621	1
9834	0	0.04700854700854701	G	A	234	236	11	11	0	220	143	77	b	FALSE	0	1.5	0.075	0.982339853907857
9887	0	0.05541346973572037	C	T	1173	1173	65	36	29	1108	512	596	b	TRUE	1	0.3481722178551377	0.06632029302484914	0.8392676481867765
9899	0	0.14883720930232558	A	G	215	232	32	28	4	181	77	104	b	TRUE	1	1.5284722222222222	0.3021894822999795	0.9999983006269725
9905	0	0.04392764857881137	G	A	387	390	17	17	0	367	207	160	b	FALSE	0	1.714285714285714	0.079408330089529	0.9998473938724898
9928	0	0.06	C	T	250	261	15	0	15	231	113	118	b	FALSE	0	1.849624060150376	0.12010545845132312	0.9999278814473278
9934	0	0.058666666666666666	T	C	375	388	22	0	22	351	102	249	b	FALSE	0	1.3763837638376384	0.08626906781888331	0.9990448816332902
9994	0	0.04112718964204113	T	C	1313	1330	54	1	53	1257	790	467	b	FALSE	0	2.443773298972414	0.10616724500919908	1
10185	0	0.08092485549132948	T	C	173	221	14	1	13	158	10	148	b	FALSE	0	0.12486891989997582	0.0909734184362693	0
10193	0	0.053169734151329244	A	G	489	492	26	4	22	463	241	222	b	FALSE	0	1.3887111717322491	0.09367240717764995	0.9997865610245552
10198	0	0.14009661835748793	G	A	207	208	29	2	27	178	22	156	b	FALSE	0	0.45830977953646124	0.1572803462884509	0.45934726400528303
10217	0	0.07213930348258707	A	G	804	807	58	34	24	744	438	306	b	TRUE	1	0.009587694596461317	0.0727496396441175	0
10226	0	0.03468208092485549	A	G	173	173	6	6	0	167	122	45	b	FALSE	0	1.3515625000000002	0.04855913173652694	0.658655468862074
10281	0	0.09739130434782609	G	A	1150	1152	112	57	55	1036	558	478	b	TRUE	1	0.10769230769230766	0.10374727447898179	0.4484504516209794
10286	0	0.100990099009901	C	T	505	508	51	43	8	451	231	220	b	TRUE	1	1.1993526825508023	0.168551608681665	0.9999952982347742
10314	0	0.05555555555555555	A	G	918	922	51	38	13	867	425	442	b	TRUE	1	0.9630360999691454	0.08441838938599198	0.9995541999102905
10319	0	0.08356940509915015	C	T	706	711	59	5	54	645	575	70	b	FALSE	0	5.093418299051677	0.4712212535892595	1
10324	0	0.05642023346303502	T	C	514	562	29	2	27	483	363	120	b	FALSE	0	3.146046099119856	0.1936346256361815	0.9999999999999136
10349	0	0.1423290203327172	T	C	541	546	77	49	28	463	217	246	b	TRUE	1	0.5752104215415778	0.19289090756719485	0.9931904742090231
10360	0	0.047244094488188976	C	T	381	381	18	1	17	362	171	191	b	FALSE	0	1.6026883323394951	0.08529592356121331	0.9996502548454852
10361	0	0.18807339449541285	T	C	436	463	82	37	45	352	202	150	b	TRUE	1	0.4020190443294843	0.2404797085759429	0.9510023856317121
10376	0	0.08617594254937164	G	A	557	561	48	31	17	509	421	88	b	TRUE	1	1.0829088530692514	0.16502156298303525	0.9942276702523585
10379	0	0.051224944320712694	A	G	449	451	23	0	23	426	212	214	b	FALSE	0	1.8945147679324894	0.10228600859729402	0.9999997395602697
1070	0	0.08447937131630648	C	T	1018	1020	86	49	37	932	516	416	c	TRUE	1	0.059753753418135325	0.08699106073033898	0.1789238819367135
1083	0	0.03684210526315789	C	A	380	383	14	0	14	360	134	226	c	FALSE	0	1.5583333333333336	0.06060185185185186	0.9971199465835913
1175	0	0.22562141491395793	A	G	523	555	118	104	14	405	64	341	c	TRUE	1	2.568953836010413	0.7678859991223059	1
1176	0	0.05217391304347826	G	A	690	696	36	35	1	653	169	484	c	FALSE	0	3.244171271028457	0.18065398275317138	1
1187	0	0.08235294117647059	T	G	255	347	21	15	6	234	203	31	c	TRUE	1	1.1335942757961108	0.16455587556504989	0.9039123032683651
1229	0	0.2746478873239437	G	A	142	158	39	39	0	102	80	22	c	FALSE	0	1.184873949579832	0.4530400395452298	0.9994791207492828
1308	0	0.034482758620689655	G	A	261	267	9	3	6	251	125	126	c	FALSE	0	0.6360479797979798	0.045980849329952916	0.4994393519774911
1337	0	0.055844770468528156	A	T	2113	2122	118	45	73	1995	1005	990	c	TRUE	1	0.4622889897703745	0.0696182264558049	0.9895657598014492
1343	0	0.05350686912509038	C	T	1383	1389	74	46	28	1272	87	1185	c	TRUE	1	5.871131897165654	0.35753757381055495	1
1403	0	0.040268456375838924	A	G	596	604	24	23	1	571	250	321	c	FALSE	0	2.0116824600520253	0.08751756124785898	0.9999998634242989
1442	0	0.0846063454759107	C	T	851	851	72	37	35	778	520	258	c	TRUE	1	0.6260088956426603	0.12183944195235837	0.9903712306601747
1457	0	0.04780876494023904	T	C	502	508	24	0	24	477	260	217	c	FALSE	0	2.0788381742738586	0.10459563141000548	0.999999987381226
1475	0	0.047752808988764044	A	G	712	716	34	9	25	678	311	367	c	TRUE	1	0.7465636254501802	0.06509005704051532	0.966992686757226
1499	0	0.08608058608058608	G	A	546	550	47	16	31	496	122	374	c	TRUE	1	0.4551821016205845	0.1172129586341835	0.8371817242914619
1516	0	0.031446540880503145	T	C	159	160	5	2	3	150	128	22	c	FALSE	0	3.243076923076923	0.12209230769230768	0.9699608850857921
1517	0	0.042735042735042736	G	T	117	120	5	1	4	111	80	31	c	FALSE	0	2.3650088183421514	0.11795922907034018	0.9715330969820167
1522	0	0.21019108280254778	G	T	157	161	33	12	21	124	18	106	c	FALSE	0	1.1163445478406109	0.4227076454152908	0.989258358177544
1586	0	0.1676300578034682	C	T	173	203	29	1	28	143	98	45	c	FALSE	0	2.2150078966328373	0.45668680288854635	0.9999999999803239
1619	0	0.031413612565445025	C	T	382	386	12	3	9	366	141	225	c	FALSE	0	0.5552884615384617	0.03889501891551072	0.45275798313023075
1622	0	0.03814713896457766	G	A	367	376	14	11	3	350	27	323	c	FALSE	0	7.2870519857927025	0.29828220858895704	0.9999999988987867
1655	0	0.11940298507462686	C	T	1072	1073	128	78	50	942	500	442	c	TRUE	1	0.27855176773004764	0.13770725005863774	0.8920153838712159
1664	0	0.07042253521126761	A	G	781	785	55	55	0	724	103	621	c	FALSE	0	4.9303797468354436	0.37454542275683617	1
1665	0	0.035634743875278395	G	A	898	901	32	32	0	865	161	704	c	FALSE	0	4.647668393782384	0.17193686543472403	1
1736	0	0.07587548638132295	A	G	514	514	39	16	23	475	216	259	c	TRUE	1	0.16599256291112502	0.08217013553693478	0.38023426870957233
1751	0	0.05555555555555555	A	G	36	36	2	2	0	34	32	2	c	FALSE	0	1.0588235294117647	0.06228373702422146	-2.220446049250313e-16
1752	0	0.05714285714285714	G	A	35	37	2	2	0	33	21	12	c	FALSE	0	1.5217391304347827	0.0922266139657444	0.46386554621848763
1840	0	0.07272727272727272	A	G	110	110	8	8	0	102	11	91	c	FALSE	0	5.7894736842105265	0.4540763673890609	0.9999998155212028
1891	0	0.03125	A	G	64	65	2	2	0	61	51	10	c	FALSE	0	1.1886792452830188	0.03897309000927931	0
1892	0	0.0392156862745098	C	A	102	102	4	0	4	97	93	4	c	FALSE	0	12.625	0.520618556701031	0.9999828554283999
1893	0	0.042105263157894736	T	C	95	101	4	0	4	90	90	0	c	FALSE	0	23.5	1.0444444444444443	0.9999996720774973
2648	0	0.15169366715758467	T	G	679	688	103	63	40	575	460	115	c	TRUE	1	0.9057923672661098	0.2676370813544686	0.9999338967783664
2654	0	0.08181818181818182	C	T	550	556	45	45	0	499	492	7	c	TRUE	1	1.0130353817504656	0.09135589614984158	0
2655	0	0.05519480519480519	G	A	308	312	17	17	0	290	196	94	c	FALSE	0	1.4413145539906105	0.08449085316496681	0.9978012910445103
2773	0	0.08828250401284109	A	C	623	625	55	27	28	568	272	296	c	FALSE	0	0.043963980195864255	0.09048549939548102	0.11161556666013761
2811	0	0.033630748112560054	G	C	1457	1459	49	3	46	1404	942	462	c	FALSE	0	2.5909830148782427	0.09341394647606373	1
2812	0	0.04291187739463601	T	A	1305	1343	56	0	56	1248	922	326	c	FALSE	0	3.4136125654450256	0.15317492280843065	1
2828	0	0.16118769883351008	C	T	943	943	152	78	74	790	103	687	c	TRUE	1	2.0680541168226103	0.46388669837970525	1
2839	0	0.03089887640449438	C	G	712	714	22	0	22	683	409	274	c	FALSE	0	2.381756756756757	0.07671837283843141	0.9999999968041705
2842	0	0.26277372262773724	G	T	274	281	72	0	72	201	168	33	c	FALSE	0	2.6	0.9313432835820895	1
2864	0	0.11937377690802348	A	G	1533	1558	183	71	112	1349	326	1023	c	TRUE	1	0.6710904713300452	0.1830604095987703	0.9999536740200975
3038	0	0.08252947481243302	T	C	933	934	77	48	29	856	431	425	c	TRUE	1	0.44023200641246685	0.10224608319908382	0.9437200394242872
3039	0	0.030100334448160536	A	G	299	301	9	1	8	289	119	170	c	FALSE	0	1.2122138992925509	0.04595725930821767	0.910267896963211
3050	0	0.08705357142857142	T	C	896	897	78	53	25	817	335	482	c	TRUE	1	1.0015769838178792	0.14226045771942492	0.9999933131786418
4082	0	0.08813559322033898	G	T	295	298	26	23	3	269	64	205	c	FALSE	0	2.835911463646875	0.28573855587219266	0.9999999999245384
4085	0	0.07727272727272727	T	C	1100	1100	85	52	33	1013	455	558	c	TRUE	1	0.6035969405333395	0.10496270082060893	0.9955131771211146
4094	0	0.42207792207792205	C	T	154	154	65	41	24	89	88	1	c	TRUE	1	1.5214502087060227	1.1331695845309642	0.9999999991005336
4105	0	0.07013574660633484	G	A	442	442	31	4	27	410	108	302	c	FALSE	0	0.6594028826355525	0.08511935651271406	0.8673314998309178
4106	0	0.08952380952380952	A	G	525	526	47	6	41	478	78	400	c	TRUE	1	0.24062816616008106	0.09481826203284661	0.3225334436787133
4113	0	0.05564924114671164	A	G	593	596	33	33	0	560	204	356	c	FALSE	0	2.50210970464135	0.14744575045207955	0.9999999999999828
4153	0	0.0429553264604811	T	C	582	583	25	1	24	557	336	221	c	FALSE	0	2.211409677224005	0.10205218868415625	0.999999992499084
4197	0	0.036036036036036036	C	T	777	778	28	1	27	748	601	147	c	FALSE	0	4.254455591378492	0.16071359651245498	1
4206	0	0.032520325203252036	A	T	246	246	8	8	0	238	108	130	c	FALSE	0	2.1206896551724137	0.07128368588814836	0.9978573044565299
4210	0	0.04365079365079365	G	A	252	253	11	10	1	241	52	189	c	FALSE	0	3.5744405000771726	0.1677644787916787	0.999995993247296
4214	0	0.17391304347826086	T	G	23	47	4	2	2	19	17	2	c	FALSE	0	2.2697368421052633	0.5415512465373962	0.8754376058723884
4218	0	0.03322259136212625	A	G	301	304	10	0	10	290	152	138	c	FALSE	0	2.027027027027027	0.06989748369058714	0.9992717524101121
4234	0	0.06896551724137931	C	T	58	68	4	1	3	50	10	40	c	FALSE	0	0.28541226215644827	0.09133192389006342	0
4238	0	0.14814814814814814	C	T	459	465	68	30	38	390	67	323	c	TRUE	1	1.3741023267690147	0.3249718268709045	0.9999967490666802
4242	0	0.04897959183673469	G	A	245	248	12	12	0	232	6	226	c	FALSE	0	13.555555555555555	0.7011494252873564	0.9999999999999998
4698	0	0.034482758620689655	A	G	696	703	24	24	0	671	255	416	c	FALSE	0	2.491039426523298	0.08909828053138472	0.999999999834389
4725	0	0.031088082901554404	G	T	193	195	6	6	0	186	24	162	c	FALSE	0	6.4	0.2064516129032258	0.9999907656794119
4726	0	0.05660377358490566	T	C	53	75	3	2	1	49	42	7	c	FALSE	0	1.3787878787878787	0.12662337662337664	0.5992760180995473
4733	0	0.08472553699284009	T	C	838	838	71	35	36	765	526	239	c	TRUE	1	0.806804750069042	0.13413358498479608	0.9986237676093208
4751	0	0.09948320413436693	T	C	774	776	77	43	34	697	535	162	c	TRUE	1	0.9958959901760551	0.1783023108813109	0.9998459781708314
4757	0	0.047619047619047616	T	C	567	573	27	0	27	537	433	104	c	FALSE	0	4.305343511450382	0.21646978549191864	1
4775	0	0.0625	A	G	176	182	11	0	11	165	31	134	c	FALSE	0	1.2137931034482758	0.08091954022988505	0.783694598810279
4776	0	0.0471976401179941	G	C	339	347	16	0	16	322	123	199	c	FALSE	0	1.572093023255814	0.07811642351581684	0.9991865606773269
4867	0	0.10789473684210527	T	C	380	409	41	0	41	339	316	23	c	FALSE	0	5.9375	0.7181047197640118	1
5591	0	0.09885057471264368	T	C	870	879	86	63	23	784	608	176	c	TRUE	1	0.21940360660265945	0.11621414961299396	0.58326703981551
5717	0	0.10677966101694915	C	T	1180	1181	126	35	91	1052	422	630	c	TRUE	1	0.46397454975985286	0.13050643583235197	0.9931956388082157
5806	0	0.03441084462982273	C	A	1918	1919	66	5	61	1850	1079	771	c	FALSE	0	1.9945200479102692	0.07558270793856586	1
5817	0	0.03869407496977025	G	A	827	849	32	28	4	795	15	780	c	FALSE	0	16.696632504746088	0.6739171315739987	1
5828	0	0.07303779069767442	T	C	2752	2752	201	170	31	2550	1439	1111	c	TRUE	1	1.0745368737321708	0.11088970861147725	0.9999999999999998
5871	0	0.03292181069958848	G	A	729	739	24	24	0	704	103	601	c	FALSE	0	5.732283464566929	0.19541875447387258	1
5906	0	0.03546099290780142	G	A	282	298	10	10	0	267	97	170	c	FALSE	0	2.588785046728972	0.09695824145052329	0.999943492182492
5915	0	0.03735632183908046	A	G	348	350	13	13	0	335	220	115	c	FALSE	0	1.4935622317596566	0.05795913138171802	0.9939004950205811
5982	0	0.06451612903225806	A	G	186	189	12	6	6	174	5	169	c	FALSE	0	7.923116883116883	0.5630810568741603	0.9999930425444722
6053	0	0.030181086519114688	T	C	497	519	15	2	13	480	277	203	c	FALSE	0	1.7495519713261647	0.06162105485862206	0.999187136538033
6056	0	0.1310734463276836	C	T	885	888	116	46	70	768	360	408	c	TRUE	1	0.25257268515195164	0.14946436300678112	0.8380192833420519
6839	0	0.045454545454545456	G	A	132	139	6	6	0	124	16	108	c	FALSE	0	5.909090909090908	0.2859237536656891	0.9999874882030623
6840	0	0.035555555555555556	C	A	225	250	8	6	2	216	164	52	c	FALSE	0	0.048801742919389934	0.03705317517953683	0
6890	0	0.12984822934232715	A	G	593	626	77	48	29	516	166	350	c	TRUE	1	1.1381126702557915	0.238046220306587	0.9999992398818648
6944	0	0.11990407673860912	G	A	417	423	50	49	1	367	0	367	c	FALSE	0	8.31733695652174	1.1331521739130435	1
6985	0	0.06390328151986183	C	A	1158	1160	74	0	74	1083	802	281	c	FALSE	0	3.259154929577465	0.22269387330446205	1
6993	0	0.031705227077977724	G	A	1167	1182	37	36	1	1130	691	439	c	FALSE	0	1.490159400991588	0.051023746736884736	0.9999992165147452
7037	0	0.059695669137729224	C	T	2563	2563	153	106	47	2410	1322	1088	c	TRUE	1	0.5497886315851958	0.0756732271573151	0.9994581176648244
7085	0	0.030141843971631204	A	G	564	570	17	17	0	547	169	378	c	FALSE	0	3.0322580645161294	0.09423836763578464	0.9999999961242384
7094	0	0.155049786628734	C	T	703	703	109	82	27	594	536	58	c	TRUE	1	1.1929134422095191	0.32605437585449004	0.9999539304923708
7108	0	0.4897119341563786	A	T	243	245	119	119	0	122	56	66	c	FALSE	0	1.3771428571428572	1.3432786885245904	1
7148	0	0.10685249709639953	T	C	861	863	92	54	38	769	398	371	c	TRUE	1	0.24856219384736097	0.12133406233437205	0.7747275128748153
7151	0	0.1386861313868613	C	T	548	548	76	47	29	472	170	302	c	TRUE	1	0.9299889427300833	0.22943286753269923	0.9999735928342087
7155	0	0.042042042042042045	G	A	666	666	28	28	0	637	89	548	c	FALSE	0	5.683760683760684	0.24983563445101908	1
7156	0	0.09072164948453608	G	A	485	485	44	44	0	439	98	341	c	FALSE	0	3.401408450704225	0.34091565337354424	1
7157	0	0.03867403314917127	C	T	362	363	14	10	4	340	310	30	c	TRUE	1	2.184611344537815	0.11866349480968857	0.9644248231871131
7175	0	0.09670079635949944	C	T	879	883	85	52	33	794	407	387	c	TRUE	1	0.35902839567199424	0.11556350499897691	0.9126468693926209
7200	0	0.04329004329004329	C	T	462	463	20	0	20	436	414	22	c	FALSE	0	10.857142857142858	0.49803407601572736	1
7204	0	0.03899721448467967	T	C	359	360	14	2	12	345	171	174	c	FALSE	0	1.3579286646599718	0.06635805721975856	0.987940596658291
7234	0	0.07142857142857142	T	G	98	140	7	0	7	90	9	81	c	FALSE	0	1.1022727272727273	0.08573232323232323	0
7240	0	0.07547169811320754	T	C	159	178	12	0	12	147	32	115	c	FALSE	0	1.2519685039370079	0.10220151052547002	0.8732179017679269
7293	0	0.05038992201559688	C	T	1667	1670	84	3	81	1583	1338	245	c	FALSE	0	4.886475536262459	0.2610654735988913	1
7379	0	0.061597690086621755	T	C	1039	1061	64	0	64	975	713	262	c	FALSE	0	3.187116564417178	0.20920560012584552	1
7407	0	0.15079365079365079	C	A	126	134	19	19	0	107	27	80	c	FALSE	0	2.739130434782609	0.4863876472978464	0.9999999997387146
7410	0	0.03296703296703297	G	T	273	277	9	9	0	259	195	64	c	FALSE	0	1.3137254901960784	0.045650692709516244	0.8798068098775207
7447	0	0.07664233576642336	T	A	274	277	21	0	21	251	186	65	c	FALSE	0	3.1627906976744184	0.2646159547855091	0.9999999999951462
7451	0	0.11330935251798561	C	T	556	560	63	45	18	493	324	169	c	TRUE	1	0.22676446779746637	0.12429656246535888	0.6013652133035046
7455	0	0.03691813804173355	T	C	623	629	23	0	23	600	483	117	c	FALSE	0	4.449999999999999	0.17058333333333334	0.9999999999999998
7493	0	0.1	G	T	270	270	27	14	13	243	140	103	c	TRUE	1	0.2115987460815047	0.11320097526994079	0.31736852663256276
7505	0	0.11002785515320335	T	C	718	736	79	43	36	639	523	116	c	TRUE	1	1.4620877012498144	0.24590522491467307	0.9999997613096742
7538	0	0.04258675078864353	A	G	634	635	27	17	10	606	171	435	c	TRUE	1	1.5931349111482986	0.09233182163542675	0.9996845534648762
7568	0	0.09090909090909091	T	C	594	616	54	35	19	540	309	231	c	TRUE	1	0.28318604651162793	0.10341279069767442	0.6864275217089051
8007	0	0.08842105263157894	G	A	475	475	42	23	19	433	226	207	c	TRUE	1	0.0938541354630489	0.09281028547142442	0.1283191590688899
8048	0	0.12903225806451613	G	A	155	157	20	20	0	135	1	134	c	FALSE	0	7.3809523809523805	1.09347442680776	1
8050	0	0.056	G	T	125	126	7	7	0	118	11	107	c	FALSE	0	6.944444444444445	0.4119585687382298	0.9999996009061052
8097	0	0.03508771929824561	C	T	285	285	10	0	10	275	180	95	c	FALSE	0	2.7142857142857144	0.09870129870129869	0.9999652636085121
8105	0	0.05389221556886228	C	T	668	669	36	26	10	631	380	251	c	TRUE	1	0.4766313932980601	0.06509940260418429	0.8356632638847512
8108	0	0.04885057471264368	A	G	348	358	17	17	0	328	104	224	c	FALSE	0	2.8512396694214877	0.14777766579318685	0.9999999915578047
8124	0	0.032989690721649485	A	G	485	493	16	16	0	469	179	290	c	FALSE	0	2.4871794871794872	0.0848504729101744	0.9999996818228555
8185	0	0.060240963855421686	A	G	166	166	10	0	10	155	101	54	c	FALSE	0	2.578125	0.1663306451612903	0.999951466217028
9200	0	0.03991130820399113	G	A	902	905	36	30	6	866	602	264	c	TRUE	1	0.63255586810439135	0.04834293175860691	0.9061383579335957
9225	0	0.12040133779264214	C	T	897	897	108	66	42	789	251	538	c	TRUE	1	1.1277956053518983	0.21956059309467982	0.9999999934961409
9242	0	0.09392265193370165	T	C	724	727	68	30	38	655	453	202	c	TRUE	1	1.0230612897332845	0.16391565122564125	0.9999342962810477
9272	0	0.08365384615384615	C	T	1040	1040	87	44	43	953	446	507	c	TRUE	1	0.13883522060861953	0.09033214125104397	0.49656819847834577
9277	0	0.04092071611253197	C	T	782	782	32	0	32	750	653	97	c	FALSE	0	6.062015503875968	0.25864599483204137	1
9296	0	0.13126491646778043	T	C	838	838	110	63	47	726	129	597	c	TRUE	1	1.9390916149068325	0.3502655632411067	1
9344	0	0.034375	G	A	320	331	11	6	5	309	6	303	c	FALSE	0	14.073199527744983	0.5093935191022569	0.9999997238248749
9758	0	0.044374009508716325	A	G	631	631	28	4	24	596	132	464	c	TRUE	1	0.44055655048904807	0.04997637739219354	0.5185072278788705
9818	0	0.22083333333333333	G	A	240	274	53	53	0	187	5	182	c	FALSE	0	4.137931034482759	1.1727825926608888	1
9834	0	0.050505050505050504	G	A	198	202	10	10	0	187	120	67	c	FALSE	0	1.5153846153846156	0.08103661044837517	0.9830038256430019
9887	0	0.0627763041556145	C	T	1131	1132	71	41	30	1060	477	583	c	TRUE	1	0.48124747781251226	0.08031911543330793	0.9516563013888218
9899	0	0.18316831683168316	A	G	202	221	37	31	6	164	76	88	c	TRUE	1	1.2271312871829874	0.33241831523505133	0.9999615981124167
9928	0	0.04332129963898917	C	T	277	284	12	0	12	262	137	125	c	FALSE	0	2	0.0916030534351145	0.9996202991984356
9934	0	0.05191256830601093	T	C	366	382	19	1	18	344	123	221	c	FALSE	0	1.2848154094238162	0.07883266580243387	0.9949188702880468
9994	0	0.03857566765578635	T	C	1348	1365	52	0	52	1296	752	544	c	FALSE	0	2.261744966442953	0.09074902643135305	1
10193	0	0.05465587044534413	A	G	494	495	27	6	21	467	241	226	c	FALSE	0	1.111111111111111	0.08775108583516113	0.9953103716164253
10198	0	0.10638297872340426	G	A	188	192	20	2	18	168	25	143	c	FALSE	0	0.3546353807223373	0.1158434388248053	0.25640120009636846
10217	0	0.07850707850707851	A	G	777	779	61	35	26	714	447	267	c	TRUE	1	0.20484258111577	0.08932431681408916	0.5866524493065175
10226	0	0.06896551724137931	A	G	174	178	12	12	0	162	116	46	c	FALSE	0	1.359375	0.10069444444444445	0.9623401704679038
10281	0	0.1015625	G	A	1152	1152	117	60	57	1032	562	470	c	TRUE	1	0.11486435430131778	0.10880541324095919	0.44272334259887147
10286	0	0.13135593220338984	C	T	472	478	62	44	18	409	201	208	c	TRUE	1	0.7592658188025424	0.19034395418595418	0.9984287147023312
10310	0	0.04040404040404041	G	T	297	298	12	12	0	283	16	267	c	FALSE	0	10.535714285714286	0.44674406865219585	0.9999999999999579
10314	0	0.046413502109704644	A	G	948	949	44	32	12	904	450	454	c	TRUE	1	0.8755850492890366	0.06782858905244506	0.99688110513057
10319	0	0.06857142857142857	C	T	700	701	48	6	42	650	598	52	c	FALSE	0	6.352886783147809	0.4750373397210088	1
10324	0	0.06471816283924843	T	C	479	525	31	0	31	447	334	113	c	FALSE	0	3.3194444444444446	0.23020755654983843	1
10342	0	0.030395136778115502	A	T	329	333	10	10	0	317	223	94	c	FALSE	0	1.4034334763948497	0.04427234941308674	0.9317370855536657
10349	0	0.13195876288659794	T	C	485	487	64	36	28	419	152	267	c	TRUE	1	0.7288327172737107	0.19978689838168426	0.996427359358135
10360	0	0.059670781893004114	C	T	486	487	29	1	28	457	277	180	c	FALSE	0	2.1956853615251033	0.14264276173742035	0.9999999997162476
10361	0	0.12134831460674157	T	C	445	465	54	26	28	391	249	142	c	TRUE	1	0.5781738958209547	0.16973015851306808	0.9641445979002877
10376	0	0.10734463276836158	G	A	531	531	57	33	24	473	387	86	c	TRUE	1	1.298131692868535	0.2252656434474616	0.9999037861576066
