Pos	Qual	Freq	Ref	Base	UngappedCoverage	TotalCoverage	VariantCov	ForwardVariantCov	ReverseVariantCov	RefCov	ForwardRefCov	ReverseRefCov	replica	State	Decision	ForwardAF	ReverseAF
1070	0	0.09187620889748549	C	T	1034	1035	95	49	46	938	558	380	a	TRUE	1	0.08072487644151564	0.107981220657277
1129	0	0.03853211009174312	G	A	545	548	21	19	2	522	134	388	a	FALSE	0	0.12418300653594772	0.005128205128205128
1175	0	0.24737945492662475	A	G	477	515	118	105	13	359	55	304	a	TRUE	1	0.65625	0.04100946372239748
1176	0	0.04354354354354354	G	A	666	668	29	29	0	637	178	459	a	FALSE	0	0.14009661835748793	0
1183	0	0.031088082901554404	C	T	386	390	12	4	8	366	365	1	a	FALSE	0	0.01084010840108401	0.8888888888888888
1187	0	0.11406844106463879	T	G	263	351	30	29	1	233	207	26	a	TRUE	1	0.1228813559322034	0.037037037037037035
1229	0	0.24347826086956523	G	A	115	132	28	28	0	85	63	22	a	FALSE	0	0.3076923076923077	0
1337	0	0.07611297271421733	A	T	2089	2098	159	74	85	1928	992	936	a	TRUE	1	0.06941838649155722	0.0832517140058766
1343	0	0.06802721088435375	C	T	1323	1331	90	41	49	1204	81	1123	a	TRUE	1	0.3360655737704918	0.041808873720136516
1442	0	0.08354755784061697	C	T	778	780	65	35	30	713	488	225	a	TRUE	1	0.06692160611854685	0.11764705882352941
1457	0	0.033797216699801194	T	C	503	509	17	0	17	486	269	217	a	FALSE	0	0	0.07264957264957266
1475	0	0.06752873563218391	A	G	696	696	47	4	43	648	292	356	a	TRUE	1	0.013513513513513514	0.10776942355889724
1499	0	0.10185185185185185	G	A	540	547	55	11	44	484	128	356	a	TRUE	1	0.07913669064748201	0.11
1517	0	0.053763440860215055	G	T	93	97	5	0	5	88	66	22	a	FALSE	0	0	0.18518518518518517
1522	0	0.16312056737588654	G	T	141	143	23	10	13	118	16	102	a	FALSE	0	0.38461538461538464	0.11304347826086956
1586	0	0.1952662721893491	C	T	169	204	33	1	32	135	96	39	a	FALSE	0	0.010309278350515464	0.4507042253521127
1622	0	0.05194805194805195	G	A	385	395	20	15	5	364	24	340	a	FALSE	0	0.38461538461538464	0.014492753623188406
1655	0	0.13399503722084366	C	T	1209	1209	162	87	75	1046	570	476	a	TRUE	1	0.1324200913242009	0.13611615245009073
1664	0	0.09924812030075188	A	G	665	670	66	66	0	596	113	483	a	FALSE	0	0.3687150837988827	0
1665	0	0.06378378378378378	G	A	925	928	59	58	1	863	171	692	a	FALSE	0	0.25327510917030566	0.001443001443001443
1736	0	0.07319952774498228	A	G	847	847	62	23	39	785	366	419	a	TRUE	1	0.05912596401028278	0.0851528384279476
1756	0	0.03164556962025317	G	A	316	321	10	10	0	306	5	301	a	FALSE	0	0.6666666666666666	0
1768	0	0.030612244897959183	C	A	392	392	12	0	12	380	102	278	a	FALSE	0	0	0.041379310344827586
1840	0	0.08974358974358974	A	G	156	158	14	14	0	142	10	132	a	FALSE	0	0.5833333333333334	0
1895	0	0.03048780487804878	C	T	164	175	5	0	5	158	99	59	a	FALSE	0	0	0.078125
2648	0	0.17440225035161744	T	G	711	731	124	59	65	587	493	94	a	TRUE	1	0.1068840579710145	0.4088050314465409
2654	0	0.0706713780918728	C	T	566	568	40	40	0	522	509	13	a	TRUE	1	0.07285974499089254	0
2655	0	0.07278481012658228	G	A	316	320	23	22	1	293	212	81	a	FALSE	0	0.09401709401709402	0.012195121951219513
2773	0	0.07378335949764521	A	C	637	641	47	30	17	590	350	240	a	FALSE	0	0.07894736842105263	0.06614785992217899
2811	0	0.048143053645116916	G	C	1454	1459	70	0	70	1381	1054	327	a	FALSE	0	0	0.17632241813602015
2812	0	0.05114503816793893	T	A	1310	1372	67	0	67	1237	1044	193	a	FALSE	0	0	0.25769230769230766
2828	0	0.1681329423264907	C	T	1023	1023	172	89	83	850	114	736	a	TRUE	1	0.43842364532019706	0.10134310134310134
2842	0	0.2677165354330709	G	T	254	269	68	1	67	184	157	27	a	FALSE	0	0.006329113924050633	0.7127659574468085
2864	0	0.1415327564894932	A	G	1618	1637	229	98	131	1389	363	1026	a	TRUE	1	0.21258134490238612	0.1132238547968885
3022	0	0.032520325203252036	A	G	246	264	8	7	1	238	38	200	a	FALSE	0	0.15555555555555556	0.004975124378109453
3038	0	0.100169779286927	T	C	1178	1178	118	79	39	1059	612	447	a	TRUE	1	0.11432706222865413	0.08024691358024691
3050	0	0.08061224489795918	T	C	980	983	79	59	20	900	459	441	a	TRUE	1	0.1138996138996139	0.04338394793926247
4082	0	0.1532567049808429	G	T	261	262	40	38	2	221	60	161	a	FALSE	0	0.3877551020408163	0.012269938650306749
4085	0	0.09457092819614711	T	C	1142	1142	108	74	34	1033	495	538	a	TRUE	1	0.13005272407732865	0.05944055944055944
4093	0	0.041666666666666664	T	C	96	97	4	4	0	92	86	6	a	FALSE	0	0.044444444444444446	0
4094	0	0.5030674846625767	C	T	163	166	82	59	23	81	80	1	a	TRUE	1	0.4244604316546763	0.9583333333333334
4105	0	0.057569296375266525	G	A	469	469	27	2	25	442	118	324	a	FALSE	0	0.016666666666666666	0.07163323782234957
4106	0	0.10894941634241245	A	G	514	514	56	3	53	458	87	371	a	TRUE	1	0.03333333333333333	0.125
4113	0	0.05410122164048865	A	G	573	577	31	31	0	542	191	351	a	FALSE	0	0.13963963963963963	0
4153	0	0.03305785123966942	T	C	605	607	20	1	19	585	315	270	a	FALSE	0	0.0031645569620253164	0.0657439446366782
4210	0	0.04417670682730924	G	A	249	257	11	10	1	237	52	185	a	FALSE	0	0.16129032258064516	0.005376344086021506
4213	0	0.030864197530864196	G	T	162	164	5	5	0	153	6	147	a	FALSE	0	0.45454545454545453	0
4214	0	0.041666666666666664	T	A	24	42	1	0	1	23	21	2	a	FALSE	0	0	0.3333333333333333
4230	0	0.030303030303030304	C	G	231	232	7	0	7	223	122	101	a	FALSE	0	0	0.06481481481481481
4234	0	0.08974358974358974	C	T	78	89	7	0	7	67	12	55	a	FALSE	0	0	0.11290322580645161
4235	0	0.030927835051546393	T	C	97	158	3	0	3	92	1	91	a	FALSE	0	0	0.031914893617021274
4238	0	0.19456066945606695	C	T	478	490	93	44	49	385	50	335	a	TRUE	1	0.46808510638297873	0.12760416666666666
4242	0	0.03474903474903475	G	A	259	267	9	9	0	250	5	245	a	FALSE	0	0.6428571428571429	0
4705	0	0.031914893617021274	T	C	564	568	18	0	18	544	479	65	a	FALSE	0	0	0.21686746987951808
4725	0	0.04020100502512563	G	T	199	201	8	8	0	189	17	172	a	FALSE	0	0.32	0
4751	0	0.059379217273954114	T	C	741	743	44	29	15	697	471	226	a	TRUE	1	0.058	0.06224066390041494
4757	0	0.08088235294117647	T	C	544	551	44	2	42	497	352	145	a	FALSE	0	0.005649717514124294	0.22459893048128343
4775	0	0.10599078341013825	A	G	217	222	23	1	22	194	41	153	a	FALSE	0	0.023809523809523808	0.12571428571428572
4776	0	0.0546448087431694	G	C	366	371	20	0	20	345	111	234	a	FALSE	0	0	0.07874015748031496
4867	0	0.14626865671641792	T	C	335	360	49	0	49	286	252	34	a	FALSE	0	0	0.5903614457831325
5591	0	0.2118918918918919	T	C	925	932	196	161	35	729	539	190	a	TRUE	1	0.23	0.15555555555555556
5633	0	0.037168141592920353	C	T	1130	1130	42	0	42	1088	653	435	a	FALSE	0	0	0.0880503144654088
5717	0	0.1502546689303905	C	T	1178	1179	177	54	123	999	375	624	a	TRUE	1	0.1258741258741259	0.1646586345381526
5806	0	0.030541871921182268	C	A	2030	2031	62	4	58	1967	1127	840	a	FALSE	0	0.0035366931918656055	0.0645879732739421
5817	0	0.047953216374269005	G	A	855	881	41	41	0	814	13	801	a	FALSE	0	0.7592592592592593	0
5828	0	0.09728183118741059	T	C	2796	2797	272	233	39	2524	1363	1161	a	TRUE	1	0.14598997493734336	0.0325
5871	0	0.03561643835616438	G	A	730	740	26	26	0	703	90	613	a	FALSE	0	0.22413793103448276	0
5906	0	0.030211480362537766	G	A	331	362	10	10	0	314	111	203	a	FALSE	0	0.08264462809917356	0
6056	0	0.10287081339712918	C	T	836	838	86	26	60	749	341	408	a	TRUE	1	0.07084468664850137	0.1282051282051282
6804	0	0.042643923240938165	C	T	469	471	20	0	20	449	184	265	a	FALSE	0	0	0.07017543859649122
6890	0	0.14056939501779359	A	G	562	585	79	57	22	483	141	342	a	TRUE	1	0.2878787878787879	0.06043956043956044
6944	0	0.13978494623655913	G	A	372	379	52	48	4	320	0	320	a	FALSE	0	1	0.012345679012345678
6985	0	0.07534246575342465	C	A	1168	1170	88	1	87	1080	781	299	a	FALSE	0	0.0012787723785166241	0.22538860103626943
6993	0	0.03930530164533821	G	A	1094	1113	43	43	0	1049	610	439	a	FALSE	0	0.06584992343032159	0
7037	0	0.09095260890378172	C	T	2089	2091	190	129	61	1899	1283	616	a	TRUE	1	0.09135977337110482	0.09010339734121123
7094	0	0.14533965244865718	C	T	633	634	92	73	19	539	502	37	a	TRUE	1	0.12695652173913044	0.3392857142857143
7107	0	0.030837004405286344	T	A	454	454	14	1	13	438	257	181	a	FALSE	0	0.003875968992248062	0.06701030927835051
7108	0	0.5042016806722689	A	T	238	238	120	120	0	115	58	57	a	FALSE	0	0.6741573033707865	0
7112	0	0.030373831775700934	C	G	428	433	13	11	2	408	216	192	a	FALSE	0	0.048458149779735685	0.010309278350515464
7148	0	0.16988416988416988	T	C	777	777	132	74	58	644	346	298	a	TRUE	1	0.1761904761904762	0.16292134831460675
7151	0	0.204	C	T	500	501	102	54	48	397	177	220	a	TRUE	1	0.23376623376623376	0.1791044776119403
7155	0	0.04940119760479042	G	A	668	669	33	32	1	632	128	504	a	FALSE	0	0.2	0.0019801980198019802
7156	0	0.04375	G	A	480	480	21	21	0	458	140	318	a	FALSE	0	0.13043478260869565	0
7168	0	0.031578947368421054	C	T	760	773	24	1	23	735	658	77	a	FALSE	0	0.0015174506828528073	0.23
7175	0	0.13918918918918918	C	T	740	743	103	64	39	637	349	288	a	TRUE	1	0.1549636803874092	0.11926605504587157
7204	0	0.05757575757575758	T	C	330	333	19	1	18	311	187	124	a	FALSE	0	0.005319148936170213	0.1267605633802817
7208	0	0.03827751196172249	A	G	418	427	16	16	0	402	60	342	a	FALSE	0	0.21052631578947367	0
7214	0	0.030418250950570342	C	T	526	527	16	0	16	510	382	128	a	FALSE	0	0	0.1111111111111111
7220	0	0.04390243902439024	A	T	205	206	9	7	2	191	84	107	a	FALSE	0	0.07692307692307693	0.01834862385321101
7234	0	0.06976744186046512	T	G	86	107	6	0	6	80	9	71	a	FALSE	0	0	0.07792207792207792
7240	0	0.08029197080291971	T	C	137	155	11	0	11	126	47	79	a	FALSE	0	0	0.12222222222222222
7281	0	0.034666666666666665	T	C	375	409	13	13	0	360	106	254	a	FALSE	0	0.1092436974789916	0
7293	0	0.043209876543209874	C	T	1782	1783	77	3	74	1703	1462	241	a	FALSE	0	0.0020477815699658703	0.23492063492063492
7379	0	0.0708502024291498	T	C	988	1020	70	2	68	917	665	252	a	FALSE	0	0.0029985007496251873	0.2125
7407	0	0.10071942446043165	C	A	139	149	14	13	1	124	21	103	a	FALSE	0	0.38235294117647056	0.009615384615384616
7447	0	0.06691449814126393	T	A	269	270	18	0	18	250	178	72	a	FALSE	0	0	0.2
7451	0	0.09608540925266904	C	T	562	570	54	35	19	506	338	168	a	TRUE	1	0.0938337801608579	0.10160427807486631
7455	0	0.03554868624420402	T	C	647	659	23	1	22	624	492	132	a	FALSE	0	0.002028397565922921	0.14285714285714285
7493	0	0.099644128113879	G	T	281	281	28	11	17	252	143	109	a	TRUE	1	0.07142857142857142	0.1349206349206349
7505	0	0.11205673758865248	T	C	705	718	79	41	38	626	469	157	a	TRUE	1	0.0803921568627451	0.19487179487179487
7538	0	0.04783258594917788	A	G	669	673	32	18	14	637	176	461	a	TRUE	1	0.09278350515463918	0.029473684210526315
7568	0	0.0920138888888889	T	C	576	603	53	33	20	521	301	220	a	TRUE	1	0.09880239520958084	0.08333333333333333
8007	0	0.08600583090379009	G	A	686	687	59	21	38	625	333	292	a	TRUE	1	0.059322033898305086	0.11515151515151516
8048	0	0.1382488479262673	G	A	217	218	30	30	0	187	2	185	a	FALSE	0	0.9375	0
8050	0	0.07344632768361582	G	T	177	177	13	13	0	164	14	150	a	FALSE	0	0.48148148148148145	0
8097	0	0.04871794871794872	C	T	390	392	19	1	18	370	244	126	a	FALSE	0	0.004081632653061225	0.125
8105	0	0.08	C	T	950	950	76	36	40	872	542	330	a	TRUE	1	0.06228373702422145	0.10810810810810811
8108	0	0.06369426751592357	A	G	471	481	30	30	0	436	152	284	a	FALSE	0	0.16483516483516483	0
8124	0	0.0364741641337386	A	G	658	668	24	24	0	634	225	409	a	FALSE	0	0.0963855421686747	0
8185	0	0.037209302325581395	A	G	215	217	8	0	8	207	121	86	a	FALSE	0	0	0.0851063829787234
9200	0	0.03282828282828283	G	A	792	795	26	22	4	766	515	251	a	TRUE	1	0.040968342644320296	0.01568627450980392
9225	0	0.112565445026178	C	T	764	765	86	54	32	678	206	472	a	TRUE	1	0.2076923076923077	0.06349206349206349
9242	0	0.07976366322008863	T	C	677	678	54	16	38	619	440	179	a	TRUE	1	0.03508771929824561	0.17511520737327188
9272	0	0.09137577002053388	C	T	974	974	89	33	56	885	445	440	a	TRUE	1	0.06903765690376569	0.11290322580645161
9277	0	0.05234159779614325	C	T	726	727	38	0	38	685	603	82	a	FALSE	0	0	0.31666666666666665
9296	0	0.1265984654731458	T	C	782	783	99	43	56	681	146	535	a	TRUE	1	0.2275132275132275	0.09475465313028765
9818	0	0.13191489361702127	G	A	235	254	31	30	1	204	33	171	a	FALSE	0	0.47619047619047616	0.005813953488372093
9834	0	0.04332129963898917	G	A	277	282	12	12	0	263	173	90	a	FALSE	0	0.06486486486486487	0
9887	0	0.04965753424657534	C	T	1168	1168	58	43	15	1110	474	636	a	TRUE	1	0.08317214700193423	0.02304147465437788
9899	0	0.125	A	G	176	192	22	19	3	152	67	85	a	TRUE	1	0.22093023255813954	0.03409090909090909
9905	0	0.0380952380952381	G	A	420	425	16	16	0	403	223	180	a	FALSE	0	0.06694560669456066	0
9927	0	0.03293413173652695	G	T	668	669	22	22	0	646	251	395	a	FALSE	0	0.08058608058608059	0
9928	0	0.0436241610738255	C	T	298	305	13	0	13	283	134	149	a	FALSE	0	0	0.08024691358024691
9934	0	0.04986149584487535	T	C	361	373	18	0	18	342	132	210	a	FALSE	0	0	0.07894736842105263
9994	0	0.03878326996197719	T	C	1315	1326	51	0	51	1262	736	526	a	FALSE	0	0	0.08838821490467938
10185	0	0.05759162303664921	T	C	191	242	11	0	11	179	12	167	a	FALSE	0	0	0.06179775280898876
10198	0	0.07075471698113207	G	A	212	218	15	4	11	197	22	175	a	FALSE	0	0.15384615384615385	0.05913978494623656
10217	0	0.08678237650200267	A	G	749	754	65	33	32	683	393	290	a	TRUE	1	0.07746478873239436	0.09937888198757763
10281	0	0.10549645390070922	G	A	1128	1128	119	64	55	1006	528	478	a	TRUE	1	0.10810810810810811	0.10318949343339587
10286	0	0.12435233160621761	C	T	579	581	72	57	15	505	264	241	a	TRUE	1	0.17757009345794392	0.05859375
10314	0	0.05825242718446602	A	G	927	930	54	31	23	873	428	445	a	TRUE	1	0.06753812636165578	0.049145299145299144
10319	0	0.08605341246290801	C	T	674	680	58	3	55	616	572	44	a	FALSE	0	0.0052173913043478265	0.5555555555555556
10324	0	0.052845528455284556	T	C	492	537	26	0	26	465	357	108	a	FALSE	0	0	0.19402985074626866
10342	0	0.03324808184143223	A	T	391	393	13	13	0	376	261	115	a	FALSE	0	0.04744525547445255	0
10349	0	0.13006756756756757	T	C	592	599	77	54	23	514	215	299	a	TRUE	1	0.20074349442379183	0.07142857142857142
10360	0	0.03551401869158879	C	T	535	535	19	3	16	516	214	302	a	FALSE	0	0.013824884792626729	0.050314465408805034
10361	0	0.19083969465648856	T	C	524	550	100	39	61	424	210	214	a	TRUE	1	0.1566265060240964	0.22181818181818183
10376	0	0.09090909090909091	G	A	572	573	52	30	22	520	412	108	a	TRUE	1	0.06787330316742081	0.16923076923076924
10379	0	0.04121475054229935	A	G	461	466	19	0	19	442	197	245	a	FALSE	0	0	0.07196969696969698
1070	0	0.1492094861660079	C	T	1012	1014	151	80	71	861	521	340	b	TRUE	1	0.13311148086522462	0.17274939172749393
1083	0	0.03216374269005848	C	A	342	345	11	0	11	324	141	183	b	FALSE	0	0	0.05670103092783505
1129	0	0.07377049180327869	G	A	488	489	36	35	1	452	86	366	b	FALSE	0	0.2892561983471074	0.0027247956403269754
1175	0	0.3107569721115538	A	G	502	537	156	128	28	346	61	285	b	TRUE	1	0.6772486772486772	0.08945686900958466
1176	0	0.049926578560939794	G	A	681	682	34	34	0	647	179	468	b	FALSE	0	0.1596244131455399	0
1187	0	0.14285714285714285	T	G	252	344	36	32	4	213	199	14	b	TRUE	1	0.13852813852813853	0.2222222222222222
1215	0	0.03171247357293869	G	A	473	473	15	15	0	458	66	392	b	FALSE	0	0.18518518518518517	0
1229	0	0.20125786163522014	G	A	159	178	32	32	0	127	101	26	b	FALSE	0	0.24060150375939848	0
1308	0	0.030303030303030304	G	A	231	240	7	1	6	224	95	129	b	FALSE	0	0.010416666666666666	0.044444444444444446
1337	0	0.08461538461538462	A	T	1950	1959	165	56	109	1781	860	921	b	TRUE	1	0.0611353711790393	0.10582524271844661
1343	0	0.07686453576864535	C	T	1314	1320	101	47	54	1169	72	1097	b	TRUE	1	0.3949579831932773	0.04691572545612511
1442	0	0.08831168831168831	C	T	770	771	68	43	25	701	466	235	b	TRUE	1	0.08447937131630648	0.09615384615384616
1457	0	0.03822937625754527	T	C	497	499	19	1	18	476	245	231	b	FALSE	0	0.0040650406504065045	0.07228915662650602
1475	0	0.05649717514124294	A	G	708	709	40	5	35	667	336	331	b	TRUE	1	0.01466275659824047	0.09562841530054644
1499	0	0.09107806691449814	G	A	538	549	49	13	36	486	130	356	b	TRUE	1	0.09090909090909091	0.09183673469387756
1516	0	0.044585987261146494	T	C	157	157	7	0	7	150	126	24	b	FALSE	0	0	0.22580645161290322
1517	0	0.08421052631578947	G	T	95	98	8	0	8	87	66	21	b	FALSE	0	0	0.27586206896551724
1519	0	0.03187250996015936	G	A	251	251	8	7	1	243	75	168	b	FALSE	0	0.08536585365853659	0.005917159763313609
1522	0	0.1888111888111888	G	T	143	147	27	8	19	116	15	101	b	FALSE	0	0.34782608695652173	0.15833333333333333
1586	0	0.165	C	T	200	239	33	1	32	166	122	44	b	FALSE	0	0.008130081300813009	0.42105263157894735
1655	0	0.14494875549048317	C	T	1366	1368	198	122	76	1165	657	508	b	TRUE	1	0.15661103979460847	0.13013698630136986
1664	0	0.09314359637774904	A	G	773	777	72	72	0	696	105	591	b	FALSE	0	0.4067796610169492	0
1665	0	0.06660412757973734	G	A	1066	1070	71	71	0	993	174	819	b	FALSE	0	0.2897959183673469	0
1736	0	0.09803921568627451	A	G	1020	1020	100	42	58	920	440	480	b	TRUE	1	0.08713692946058091	0.10780669144981413
1768	0	0.03854389721627409	C	A	467	467	18	0	18	449	143	306	b	FALSE	0	0	0.05555555555555555
1840	0	0.11290322580645161	A	G	186	187	21	21	0	165	17	148	b	FALSE	0	0.5526315789473685	0
2630	0	0.03015075376884422	G	A	199	209	6	5	1	192	123	69	b	FALSE	0	0.0390625	0.014285714285714285
2648	0	0.17524339360222532	T	G	719	733	126	89	37	590	477	113	b	TRUE	1	0.15724381625441697	0.24666666666666667
2654	0	0.09041591320072333	C	T	553	559	50	50	0	500	493	7	b	TRUE	1	0.09208103130755065	0
2655	0	0.059880239520958084	G	A	334	338	20	20	0	314	232	82	b	FALSE	0	0.07936507936507936	0
2773	0	0.059880239520958084	A	C	668	671	40	22	18	628	362	266	b	FALSE	0	0.057291666666666664	0.06338028169014084
2811	0	0.036036036036036036	G	C	1443	1449	52	1	51	1390	1061	329	b	FALSE	0	9.416195856873823e-4	0.13421052631578947
2812	0	0.04420731707317073	T	A	1312	1386	58	0	58	1251	1045	206	b	FALSE	0	0	0.2196969696969697
2828	0	0.18502673796791444	C	T	935	937	173	88	85	761	131	630	b	TRUE	1	0.4018264840182648	0.11888111888111888
2842	0	0.2736842105263158	G	T	285	296	78	0	78	206	178	28	b	FALSE	0	0	0.7358490566037735
2846	0	0.03684210526315789	G	A	380	383	14	3	11	365	6	359	b	FALSE	0	0.3333333333333333	0.02972972972972973
2864	0	0.14394904458598726	A	G	1570	1595	226	103	123	1343	376	967	b	TRUE	1	0.2150313152400835	0.11284403669724771
2884	0	0.038922155688622756	G	A	1002	1002	39	35	4	962	232	730	b	FALSE	0	0.13108614232209737	0.005449591280653951
3022	0	0.04	A	G	225	238	9	9	0	215	32	183	b	FALSE	0	0.21951219512195122	0
3038	0	0.10278745644599303	T	C	1148	1148	118	83	35	1029	573	456	b	TRUE	1	0.12652439024390244	0.07128309572301425
3050	0	0.0923226433430515	T	C	1029	1031	95	71	24	934	500	434	b	TRUE	1	0.1243432574430823	0.05240174672489083
4082	0	0.11439114391143912	G	T	271	271	31	28	3	240	57	183	b	FALSE	0	0.32941176470588235	0.016129032258064516
4085	0	0.12991452991452992	T	C	1170	1171	152	100	52	1018	502	516	b	TRUE	1	0.16611295681063123	0.09154929577464789
4094	0	0.5681818181818182	C	T	176	182	100	80	20	76	75	1	b	TRUE	1	0.5161290322580645	0.9523809523809523
4105	0	0.056925996204933584	G	A	527	527	30	4	26	497	144	353	b	FALSE	0	0.02702702702702703	0.06860158311345646
4106	0	0.14233576642335766	A	G	548	548	78	8	70	470	94	376	b	TRUE	1	0.0784313725490196	0.15695067264573992
4113	0	0.05509181969949917	A	G	599	599	33	31	2	565	222	343	b	FALSE	0	0.1225296442687747	0.005797101449275362
4153	0	0.030303030303030304	T	C	627	633	19	3	16	608	362	246	b	FALSE	0	0.00821917808219178	0.061068702290076333
4214	0	0.04	T	G	25	52	1	0	1	24	14	10	b	FALSE	0	0	0.09090909090909091
4234	0	0.10294117647058823	C	T	68	77	7	1	6	58	10	48	b	FALSE	0	0.09090909090909091	0.1111111111111111
4238	0	0.23173277661795408	C	T	479	486	111	46	65	365	60	305	b	TRUE	1	0.4339622641509434	0.17567567567567569
4242	0	0.06463878326996197	G	A	263	265	17	17	0	246	2	244	b	FALSE	0	0.8947368421052632	0
4706	0	0.0367816091954023	A	G	435	439	16	16	0	419	213	206	b	FALSE	0	0.06986899563318777	0
4725	0	0.03048780487804878	G	T	164	165	5	5	0	157	15	142	b	FALSE	0	0.25	0
4726	0	0.08333333333333333	T	G	48	68	4	1	3	44	30	14	b	FALSE	0	0.03225806451612903	0.17647058823529413
4733	0	0.08385481852315395	T	C	799	800	67	33	34	731	494	237	b	TRUE	1	0.06261859582542695	0.12546125461254612
4751	0	0.08345323741007195	T	C	695	697	58	36	22	637	441	196	b	TRUE	1	0.07547169811320754	0.10091743119266056
4757	0	0.06324110671936758	T	C	506	513	32	0	32	472	357	115	b	FALSE	0	0	0.21768707482993196
4775	0	0.061224489795918366	A	G	196	200	12	0	12	184	25	159	b	FALSE	0	0	0.07017543859649122
4776	0	0.05757575757575758	G	C	330	334	19	0	19	309	103	206	b	FALSE	0	0	0.08444444444444445
4867	0	0.10830324909747292	T	C	277	305	30	1	29	247	226	21	b	FALSE	0	0.004405286343612335	0.58
5591	0	0.17684887459807075	T	C	933	943	165	135	30	768	585	183	b	TRUE	1	0.1875	0.14084507042253522
5633	0	0.030973451327433628	C	T	1130	1131	35	0	35	1095	670	425	b	FALSE	0	0	0.07608695652173914
5682	0	0.0306030603060306	G	T	1111	1116	34	1	33	1075	874	201	b	FALSE	0	0.001142857142857143	0.14102564102564102
5717	0	0.14067524115755628	C	T	1244	1244	175	50	125	1067	390	677	b	TRUE	1	0.11363636363636363	0.15586034912718205
5752	0	0.037549407114624504	G	A	1012	1012	38	16	22	974	490	484	b	FALSE	0	0.03162055335968379	0.043478260869565216
5817	0	0.04377880184331797	G	A	868	881	38	34	4	830	17	813	b	FALSE	0	0.6666666666666666	0.004895960832313341
5828	0	0.11202185792349727	T	C	2928	2929	328	272	56	2597	1405	1192	b	TRUE	1	0.16219439475253428	0.04487179487179487
5871	0	0.03954802259887006	G	A	708	716	28	28	0	679	103	576	b	FALSE	0	0.21374045801526717	0
5906	0	0.034722222222222224	G	A	288	329	10	10	0	275	75	200	b	FALSE	0	0.11764705882352941	0
6053	0	0.03070175438596491	T	C	456	472	14	0	14	439	236	203	b	FALSE	0	0	0.06451612903225806
6056	0	0.13088404133180254	C	T	871	875	114	47	67	755	347	408	b	TRUE	1	0.11928934010152284	0.14105263157894737
6804	0	0.03070175438596491	C	T	456	457	14	1	13	441	181	260	b	FALSE	0	0.005494505494505495	0.047619047619047616
6839	0	0.03937007874015748	G	A	127	132	5	4	1	119	8	111	b	FALSE	0	0.3333333333333333	0.008928571428571428
6840	0	0.03225806451612903	C	A	217	230	7	4	3	209	170	39	b	FALSE	0	0.022988505747126436	0.07142857142857142
6890	0	0.11619718309859155	A	G	568	593	66	36	30	502	161	341	b	TRUE	1	0.18274111675126903	0.08086253369272237
6944	0	0.14285714285714285	G	A	399	406	57	56	1	341	0	341	b	FALSE	0	1	0.0029239766081871343
6952	0	0.030985915492957747	T	C	355	361	11	1	10	337	283	54	b	FALSE	0	0.0035211267605633804	0.15625
6979	0	0.03184713375796178	A	G	157	161	5	1	4	152	1	151	b	FALSE	0	0.5	0.025806451612903226
6985	0	0.08385933273219116	C	A	1109	1112	93	1	92	1016	712	304	b	FALSE	0	0.001402524544179523	0.23232323232323232
6993	0	0.03955841766329347	G	A	1087	1101	43	42	1	1041	610	431	b	FALSE	0	0.06441717791411043	0.0023148148148148147
7037	0	0.054011119936457505	C	T	2518	2518	136	94	42	2382	1346	1036	b	TRUE	1	0.06527777777777778	0.03896103896103896
7085	0	0.032692307692307694	A	G	520	529	17	17	0	503	130	373	b	FALSE	0	0.11564625850340136	0
7094	0	0.11394557823129252	C	T	588	590	67	47	20	521	483	38	b	TRUE	1	0.08867924528301886	0.3448275862068966
7108	0	0.45934959349593496	A	T	246	247	113	113	0	130	64	66	b	FALSE	0	0.6384180790960452	0
7110	0	0.036231884057971016	T	C	276	319	10	1	9	264	254	10	b	FALSE	0	0.00392156862745098	0.47368421052631576
7113	0	0.044573643410852716	T	C	516	528	23	17	6	491	263	228	b	FALSE	0	0.060714285714285714	0.02564102564102564
7148	0	0.10294117647058823	T	C	816	816	84	42	42	731	374	357	b	TRUE	1	0.10096153846153846	0.10526315789473684
7151	0	0.14663951120162932	C	T	491	493	72	32	40	419	169	250	b	TRUE	1	0.15920398009950248	0.13793103448275862
7155	0	0.04878048780487805	G	A	615	615	30	29	1	583	46	537	b	FALSE	0	0.38666666666666666	0.0018587360594795538
7156	0	0.0787037037037037	G	A	432	434	34	34	0	396	60	336	b	FALSE	0	0.3617021276595745	0
7168	0	0.03634085213032581	C	T	798	813	29	0	29	769	665	104	b	FALSE	0	0	0.21804511278195488
7175	0	0.07953063885267275	C	T	767	768	61	31	30	706	349	357	b	TRUE	1	0.08157894736842106	0.07751937984496124
7204	0	0.04452054794520548	T	C	292	292	13	3	10	279	142	137	b	FALSE	0	0.020689655172413793	0.06802721088435375
7214	0	0.03910614525139665	C	T	537	537	21	2	19	516	372	144	b	FALSE	0	0.0053475935828877	0.1165644171779141
7240	0	0.07407407407407407	T	C	135	153	10	0	10	125	49	76	b	FALSE	0	0	0.11627906976744186
7281	0	0.030952380952380953	T	C	420	451	13	11	2	406	116	290	b	FALSE	0	0.08661417322834646	0.00684931506849315
7379	0	0.066795740561471445	T	C	1033	1059	69	1	68	963	670	293	b	FALSE	0	0.0014903129657228018	0.1883656509695291
7407	0	0.12686567164179105	C	A	134	142	17	17	0	113	22	91	b	FALSE	0	0.4358974358974359	0
7415	0	0.04866180048661801	G	A	411	423	20	9	11	391	19	372	b	FALSE	0	0.32142857142857145	0.028720626631853787
7447	0	0.09386281588447654	T	A	277	279	26	0	26	249	179	70	b	FALSE	0	0	0.2708333333333333
7451	0	0.08900523560209424	C	T	573	577	51	33	18	521	380	141	b	TRUE	1	0.07990314769975787	0.11320754716981132
7455	0	0.039764359351988215	T	C	679	692	27	0	27	652	532	120	b	FALSE	0	0	0.1836734693877551
7493	0	0.09561752988047809	G	T	251	253	24	7	17	227	123	104	b	TRUE	1	0.05384615384615385	0.14049586776859505
7505	0	0.10767160161507403	T	C	743	761	80	34	46	663	510	153	b	TRUE	1	0.0625	0.23115577889447236
7538	0	0.04783258594917788	A	G	669	671	32	16	16	637	199	438	b	TRUE	1	0.07441860465116279	0.03524229074889868
7568	0	0.09491525423728814	T	C	590	617	56	30	26	534	320	214	b	TRUE	1	0.08571428571428572	0.10833333333333334
8007	0	0.08935611038107753	G	A	761	762	68	27	41	693	352	341	b	TRUE	1	0.0712401055408971	0.10732984293193717
8022	0	0.03377110694183865	T	C	533	535	18	0	18	514	419	95	b	FALSE	0	0	0.1592920353982301
8048	0	0.08733624454148471	G	A	229	233	20	19	1	209	3	206	b	FALSE	0	0.8636363636363636	0.004830917874396135
8050	0	0.045	G	T	200	200	9	9	0	190	19	171	b	FALSE	0	0.32142857142857145	0
8075	0	0.033816425120772944	G	A	621	622	21	21	0	597	127	470	b	FALSE	0	0.14189189189189189	0
8097	0	0.03233256351039261	C	T	433	434	14	1	13	418	264	154	b	FALSE	0	0.0037735849056603774	0.07784431137724551
8105	0	0.06314797360980208	C	T	1061	1062	67	38	29	994	576	418	b	TRUE	1	0.06188925081433225	0.06487695749440715
8108	0	0.05150976909413854	A	G	563	569	29	28	1	531	169	362	b	FALSE	0	0.14213197969543148	0.0027548209366391185
8124	0	0.03117206982543641	A	G	802	814	25	25	0	777	288	489	b	FALSE	0	0.07987220447284345	0
8139	0	0.032397408207343416	G	A	463	470	15	13	2	447	5	442	b	FALSE	0	0.7222222222222222	0.0045045045045045045
8185	0	0.07581227436823104	A	G	277	279	21	0	21	253	158	95	b	FALSE	0	0	0.1810344827586207
9200	0	0.030751708428246014	G	A	878	878	27	25	2	851	596	255	b	TRUE	1	0.040257648953301126	0.007782101167315175
9225	0	0.08845208845208845	C	T	814	814	72	50	22	742	233	509	b	TRUE	1	0.17667844522968199	0.04143126177024482
9242	0	0.06751054852320675	T	C	711	716	48	24	24	660	471	189	b	TRUE	1	0.048484848484848485	0.11267605633802817
9272	0	0.06705539358600583	C	T	1029	1031	69	36	33	960	486	474	b	TRUE	1	0.06896551724137931	0.0650887573964497
9277	0	0.045512010113780026	C	T	791	792	36	0	36	755	675	80	b	FALSE	0	0	0.3103448275862069
9296	0	0.10161090458488228	T	C	807	807	82	42	40	724	182	542	b	TRUE	1	0.1875	0.06872852233676977
9758	0	0.035168195718654434	A	G	654	655	23	1	22	626	155	471	b	TRUE	1	0.00641025641025641	0.04462474645030426
9800	0	0.050724637681159424	C	T	552	553	28	4	24	524	466	58	b	FALSE	0	0.00851063829787234	0.2926829268292683
9818	0	0.14666666666666667	G	A	225	262	33	32	1	192	22	170	b	FALSE	0	0.5925925925925926	0.005847953216374269
9834	0	0.04700854700854701	G	A	234	236	11	11	0	220	143	77	b	FALSE	0	0.07142857142857142	0
9887	0	0.05541346973572037	C	T	1173	1173	65	36	29	1108	512	596	b	TRUE	1	0.06569343065693431	0.0464
9899	0	0.14883720930232558	A	G	215	232	32	28	4	181	77	104	b	TRUE	1	0.26666666666666666	0.037037037037037035
9905	0	0.04392764857881137	G	A	387	390	17	17	0	367	207	160	b	FALSE	0	0.07589285714285714	0
9928	0	0.06	C	T	250	261	15	0	15	231	113	118	b	FALSE	0	0	0.11278195488721804
9934	0	0.058666666666666666	T	C	375	388	22	0	22	351	102	249	b	FALSE	0	0	0.08118081180811808
9994	0	0.04112718964204113	T	C	1313	1330	54	1	53	1257	790	467	b	FALSE	0	0.0012642225031605564	0.10192307692307692
10185	0	0.08092485549132948	T	C	173	221	14	1	13	158	10	148	b	FALSE	0	0.09090909090909091	0.08074534161490683
10193	0	0.053169734151329244	A	G	489	492	26	4	22	463	241	222	b	FALSE	0	0.0163265306122449	0.09016393442622951
10198	0	0.14009661835748793	G	A	207	208	29	2	27	178	22	156	b	FALSE	0	0.08333333333333333	0.14754098360655737
10217	0	0.07213930348258707	A	G	804	807	58	34	24	744	438	306	b	TRUE	1	0.07203389830508475	0.07272727272727272
10226	0	0.03468208092485549	A	G	173	173	6	6	0	167	122	45	b	FALSE	0	0.046875	0
10281	0	0.09739130434782609	G	A	1150	1152	112	57	55	1036	558	478	b	TRUE	1	0.09268292682926829	0.10318949343339587
10286	0	0.100990099009901	C	T	505	508	51	43	8	451	231	220	b	TRUE	1	0.15693430656934307	0.03508771929824561
10314	0	0.05555555555555555	A	G	918	922	51	38	13	867	425	442	b	TRUE	1	0.08207343412526998	0.02857142857142857
10319	0	0.08356940509915015	C	T	706	711	59	5	54	645	575	70	b	FALSE	0	0.008620689655172414	0.43548387096774194
10324	0	0.05642023346303502	T	C	514	562	29	2	27	483	363	120	b	FALSE	0	0.005479452054794521	0.1836734693877551
10349	0	0.1423290203327172	T	C	541	546	77	49	28	463	217	246	b	TRUE	1	0.18421052631578946	0.10218978102189781
10360	0	0.047244094488188976	C	T	381	381	18	1	17	362	171	191	b	FALSE	0	0.005813953488372093	0.08173076923076923
10361	0	0.18807339449541285	T	C	436	463	82	37	45	352	202	150	b	TRUE	1	0.15481171548117154	0.23076923076923078
10376	0	0.08617594254937164	G	A	557	561	48	31	17	509	421	88	b	TRUE	1	0.06858407079646017	0.1619047619047619
10379	0	0.051224944320712694	A	G	449	451	23	0	23	426	212	214	b	FALSE	0	0	0.0970464135021097
1070	0	0.08447937131630648	C	T	1018	1020	86	49	37	932	516	416	c	TRUE	1	0.08672566371681416	0.08167770419426049
1083	0	0.03684210526315789	C	A	380	383	14	0	14	360	134	226	c	FALSE	0	0	0.058333333333333334
1175	0	0.22562141491395793	A	G	523	555	118	104	14	405	64	341	c	TRUE	1	0.6190476190476191	0.03943661971830986
1176	0	0.05217391304347826	G	A	690	696	36	35	1	653	169	484	c	FALSE	0	0.1715686274509804	0.002061855670103093
1187	0	0.08235294117647059	T	G	255	347	21	15	6	234	203	31	c	TRUE	1	0.06880733944954129	0.16216216216216217
1229	0	0.2746478873239437	G	A	142	158	39	39	0	102	80	22	c	FALSE	0	0.3277310924369748	0
1308	0	0.034482758620689655	G	A	261	267	9	3	6	251	125	126	c	FALSE	0	0.0234375	0.045454545454545456
1337	0	0.055844770468528156	A	T	2113	2122	118	45	73	1995	1005	990	c	TRUE	1	0.04285714285714286	0.06867356538099718
1343	0	0.05350686912509038	C	T	1383	1389	74	46	28	1272	87	1185	c	TRUE	1	0.3458646616541353	0.023083264633140973
1403	0	0.040268456375838924	A	G	596	604	24	23	1	571	250	321	c	FALSE	0	0.08424908424908426	0.003105590062111801
1442	0	0.0846063454759107	C	T	851	851	72	37	35	778	520	258	c	TRUE	1	0.06642728904847396	0.11945392491467577
1457	0	0.04780876494023904	T	C	502	508	24	0	24	477	260	217	c	FALSE	0	0	0.0995850622406639
1475	0	0.047752808988764044	A	G	712	716	34	9	25	678	311	367	c	TRUE	1	0.028125	0.06377551020408163
1499	0	0.08608058608058608	G	A	546	550	47	16	31	496	122	374	c	TRUE	1	0.11594202898550725	0.07654320987654321
1516	0	0.031446540880503145	T	C	159	160	5	2	3	150	128	22	c	FALSE	0	0.015384615384615385	0.12
1517	0	0.042735042735042736	G	T	117	120	5	1	4	111	80	31	c	FALSE	0	0.012345679012345678	0.11428571428571428
1522	0	0.21019108280254778	G	T	157	161	33	12	21	124	18	106	c	FALSE	0	0.4	0.16535433070866143
1586	0	0.1676300578034682	C	T	173	203	29	1	28	143	98	45	c	FALSE	0	0.010101010101010102	0.3835616438356164
1619	0	0.031413612565445025	C	T	382	386	12	3	9	366	141	225	c	FALSE	0	0.020833333333333332	0.038461538461538464
1622	0	0.03814713896457766	G	A	367	376	14	11	3	350	27	323	c	FALSE	0	0.2894736842105263	0.009202453987730062
1655	0	0.11940298507462686	C	T	1072	1073	128	78	50	942	500	442	c	TRUE	1	0.13494809688581316	0.1016260162601626
1664	0	0.07042253521126761	A	G	781	785	55	55	0	724	103	621	c	FALSE	0	0.34810126582278483	0
1665	0	0.035634743875278395	G	A	898	901	32	32	0	865	161	704	c	FALSE	0	0.16580310880829016	0
1736	0	0.07587548638132295	A	G	514	514	39	16	23	475	216	259	c	TRUE	1	0.06896551724137931	0.08156028368794327
1751	0	0.05555555555555555	A	G	36	36	2	2	0	34	32	2	c	FALSE	0	0.058823529411764705	0
1752	0	0.05714285714285714	G	A	35	37	2	2	0	33	21	12	c	FALSE	0	0.08695652173913043	0
1840	0	0.07272727272727272	A	G	110	110	8	8	0	102	11	91	c	FALSE	0	0.42105263157894735	0
1891	0	0.03125	A	G	64	65	2	2	0	61	51	10	c	FALSE	0	0.03773584905660377	0
1892	0	0.0392156862745098	C	A	102	102	4	0	4	97	93	4	c	FALSE	0	0	0.5
1893	0	0.042105263157894736	T	C	95	101	4	0	4	90	90	0	c	FALSE	0	0	1
2648	0	0.15169366715758467	T	G	679	688	103	63	40	575	460	115	c	TRUE	1	0.12045889101338432	0.25806451612903225
2654	0	0.08181818181818182	C	T	550	556	45	45	0	499	492	7	c	TRUE	1	0.08379888268156424	0
2655	0	0.05519480519480519	G	A	308	312	17	17	0	290	196	94	c	FALSE	0	0.07981220657276995	0
2773	0	0.08828250401284109	A	C	623	625	55	27	28	568	272	296	c	FALSE	0	0.0903010033444816	0.08641975308641975
2811	0	0.033630748112560054	G	C	1457	1459	49	3	46	1404	942	462	c	FALSE	0	0.0031746031746031746	0.09055118110236221
2812	0	0.04291187739463601	T	A	1305	1343	56	0	56	1248	922	326	c	FALSE	0	0	0.14659685863874344
2828	0	0.16118769883351008	C	T	943	943	152	78	74	790	103	687	c	TRUE	1	0.430939226519337	0.09724047306176084
2839	0	0.03089887640449438	C	G	712	714	22	0	22	683	409	274	c	FALSE	0	0	0.07432432432432433
2842	0	0.26277372262773724	G	T	274	281	72	0	72	201	168	33	c	FALSE	0	0	0.6857142857142857
2864	0	0.11937377690802348	A	G	1533	1558	183	71	112	1349	326	1023	c	TRUE	1	0.17884130982367757	0.0986784140969163
3038	0	0.08252947481243302	T	C	933	934	77	48	29	856	431	425	c	TRUE	1	0.10020876826722339	0.06387665198237885
3039	0	0.030100334448160536	A	G	299	301	9	1	8	289	119	170	c	FALSE	0	0.008333333333333333	0.0449438202247191
3050	0	0.08705357142857142	T	C	896	897	78	53	25	817	335	482	c	TRUE	1	0.13659793814432988	0.04930966469428008
4082	0	0.08813559322033898	G	T	295	298	26	23	3	269	64	205	c	FALSE	0	0.26436781609195403	0.014423076923076924
4085	0	0.07727272727272727	T	C	1100	1100	85	52	33	1013	455	558	c	TRUE	1	0.10256410256410256	0.05583756345177665
4094	0	0.42207792207792205	C	T	154	154	65	41	24	89	88	1	c	TRUE	1	0.3178294573643411	0.96
4105	0	0.07013574660633484	G	A	442	442	31	4	27	410	108	302	c	FALSE	0	0.03571428571428571	0.08206686930091185
4106	0	0.08952380952380952	A	G	525	526	47	6	41	478	78	400	c	TRUE	1	0.07142857142857142	0.09297052154195011
4113	0	0.05564924114671164	A	G	593	596	33	33	0	560	204	356	c	FALSE	0	0.13924050632911392	0
4153	0	0.0429553264604811	T	C	582	583	25	1	24	557	336	221	c	FALSE	0	0.002967359050445104	0.09795918367346938
4197	0	0.036036036036036036	C	T	777	778	28	1	27	748	601	147	c	FALSE	0	0.0016611295681063123	0.15517241379310345
4206	0	0.032520325203252036	A	T	246	246	8	8	0	238	108	130	c	FALSE	0	0.06896551724137931	0
4210	0	0.04365079365079365	G	A	252	253	11	10	1	241	52	189	c	FALSE	0	0.16129032258064516	0.005263157894736842
4214	0	0.17391304347826086	T	G	23	47	4	2	2	19	17	2	c	FALSE	0	0.10526315789473684	0.5
4218	0	0.03322259136212625	A	G	301	304	10	0	10	290	152	138	c	FALSE	0	0	0.06756756756756757
4234	0	0.06896551724137931	C	T	58	68	4	1	3	50	10	40	c	FALSE	0	0.09090909090909091	0.06976744186046512
4238	0	0.14814814814814814	C	T	459	465	68	30	38	390	67	323	c	TRUE	1	0.30927835051546393	0.10526315789473684
4242	0	0.04897959183673469	G	A	245	248	12	12	0	232	6	226	c	FALSE	0	0.6666666666666666	0
4698	0	0.034482758620689655	A	G	696	703	24	24	0	671	255	416	c	FALSE	0	0.08602150537634409	0
4725	0	0.031088082901554404	G	T	193	195	6	6	0	186	24	162	c	FALSE	0	0.2	0
4726	0	0.05660377358490566	T	C	53	75	3	2	1	49	42	7	c	FALSE	0	0.045454545454545456	0.125
4733	0	0.08472553699284009	T	C	838	838	71	35	36	765	526	239	c	TRUE	1	0.062388591800356503	0.13090909090909092
4751	0	0.09948320413436693	T	C	774	776	77	43	34	697	535	162	c	TRUE	1	0.07439446366782007	0.17346938775510204
4757	0	0.047619047619047616	T	C	567	573	27	0	27	537	433	104	c	FALSE	0	0	0.20610687022900764
4775	0	0.0625	A	G	176	182	11	0	11	165	31	134	c	FALSE	0	0	0.07586206896551724
4776	0	0.0471976401179941	G	C	339	347	16	0	16	322	123	199	c	FALSE	0	0	0.07441860465116279
4867	0	0.10789473684210527	T	C	380	409	41	0	41	339	316	23	c	FALSE	0	0	0.640625
5591	0	0.09885057471264368	T	C	870	879	86	63	23	784	608	176	c	TRUE	1	0.09388971684053651	0.11557788944723618
5717	0	0.10677966101694915	C	T	1180	1181	126	35	91	1052	422	630	c	TRUE	1	0.07658643326039387	0.1262135922330097
5806	0	0.03441084462982273	C	A	1918	1919	66	5	61	1850	1079	771	c	FALSE	0	0.004612546125461255	0.0733173076923077
5817	0	0.03869407496977025	G	A	827	849	32	28	4	795	15	780	c	FALSE	0	0.6511627906976745	0.00510204081632653
5828	0	0.07303779069767442	T	C	2752	2752	201	170	31	2550	1439	1111	c	TRUE	1	0.10565568676196395	0.02714535901926445
5871	0	0.03292181069958848	G	A	729	739	24	24	0	704	103	601	c	FALSE	0	0.1889763779527559	0
5906	0	0.03546099290780142	G	A	282	298	10	10	0	267	97	170	c	FALSE	0	0.09345794392523364	0
5915	0	0.03735632183908046	A	G	348	350	13	13	0	335	220	115	c	FALSE	0	0.055793991416309016	0
5982	0	0.06451612903225806	A	G	186	189	12	6	6	174	5	169	c	FALSE	0	0.5454545454545454	0.03428571428571429
6053	0	0.030181086519114688	T	C	497	519	15	2	13	480	277	203	c	FALSE	0	0.007168458781362007	0.06018518518518518
6056	0	0.1310734463276836	C	T	885	888	116	46	70	768	360	408	c	TRUE	1	0.11330049261083744	0.14644351464435146
6839	0	0.045454545454545456	G	A	132	139	6	6	0	124	16	108	c	FALSE	0	0.2727272727272727	0
6840	0	0.035555555555555556	C	A	225	250	8	6	2	216	164	52	c	FALSE	0	0.03529411764705882	0.037037037037037035
6890	0	0.12984822934232715	A	G	593	626	77	48	29	516	166	350	c	TRUE	1	0.22429906542056074	0.07651715039577836
6944	0	0.11990407673860912	G	A	417	423	50	49	1	367	0	367	c	FALSE	0	1	0.002717391304347826
6985	0	0.06390328151986183	C	A	1158	1160	74	0	74	1083	802	281	c	FALSE	0	0	0.2084507042253521
6993	0	0.031705227077977724	G	A	1167	1182	37	36	1	1130	691	439	c	FALSE	0	0.04951856946354883	0.0022727272727272726
7037	0	0.059695669137729224	C	T	2563	2563	153	106	47	2410	1322	1088	c	TRUE	1	0.0742296918767507	0.04140969162995595
7085	0	0.030141843971631204	A	G	564	570	17	17	0	547	169	378	c	FALSE	0	0.0913978494623656	0
7094	0	0.155049786628734	C	T	703	703	109	82	27	594	536	58	c	TRUE	1	0.13268608414239483	0.3176470588235294
7108	0	0.4897119341563786	A	T	243	245	119	119	0	122	56	66	c	FALSE	0	0.68	0
7148	0	0.10685249709639953	T	C	861	863	92	54	38	769	398	371	c	TRUE	1	0.11946902654867257	0.09290953545232274
7151	0	0.1386861313868613	C	T	548	548	76	47	29	472	170	302	c	TRUE	1	0.21658986175115208	0.08761329305135952
7155	0	0.042042042042042045	G	A	666	666	28	28	0	637	89	548	c	FALSE	0	0.23931623931623933	0
7156	0	0.09072164948453608	G	A	485	485	44	44	0	439	98	341	c	FALSE	0	0.30985915492957744	0
7157	0	0.03867403314917127	C	T	362	363	14	10	4	340	310	30	c	TRUE	1	0.03125	0.11764705882352941
7175	0	0.09670079635949944	C	T	879	883	85	52	33	794	407	387	c	TRUE	1	0.11328976034858387	0.07857142857142857
7200	0	0.04329004329004329	C	T	462	463	20	0	20	436	414	22	c	FALSE	0	0	0.47619047619047616
7204	0	0.03899721448467967	T	C	359	360	14	2	12	345	171	174	c	FALSE	0	0.011560693641618497	0.06451612903225806
7234	0	0.07142857142857142	T	G	98	140	7	0	7	90	9	81	c	FALSE	0	0	0.07954545454545454
7240	0	0.07547169811320754	T	C	159	178	12	0	12	147	32	115	c	FALSE	0	0	0.09448818897637795
7293	0	0.05038992201559688	C	T	1667	1670	84	3	81	1583	1338	245	c	FALSE	0	0.0022371364653243847	0.24846625766871167
7379	0	0.061597690086621755	T	C	1039	1061	64	0	64	975	713	262	c	FALSE	0	0	0.19631901840490798
7407	0	0.15079365079365079	C	A	126	134	19	19	0	107	27	80	c	FALSE	0	0.41304347826086957	0
7410	0	0.03296703296703297	G	T	273	277	9	9	0	259	195	64	c	FALSE	0	0.04411764705882353	0
7447	0	0.07664233576642336	T	A	274	277	21	0	21	251	186	65	c	FALSE	0	0	0.2441860465116279
7451	0	0.11330935251798561	C	T	556	560	63	45	18	493	324	169	c	TRUE	1	0.12195121951219512	0.0962566844919786
7455	0	0.03691813804173355	T	C	623	629	23	0	23	600	483	117	c	FALSE	0	0	0.16428571428571428
7493	0	0.1	G	T	270	270	27	14	13	243	140	103	c	TRUE	1	0.09090909090909091	0.11206896551724138
7505	0	0.11002785515320335	T	C	718	736	79	43	36	639	523	116	c	TRUE	1	0.07597173144876325	0.23684210526315788
7538	0	0.04258675078864353	A	G	634	635	27	17	10	606	171	435	c	TRUE	1	0.09042553191489362	0.02247191011235955
7568	0	0.09090909090909091	T	C	594	616	54	35	19	540	309	231	c	TRUE	1	0.10174418604651163	0.076
8007	0	0.08842105263157894	G	A	475	475	42	23	19	433	226	207	c	TRUE	1	0.09236947791164658	0.084070796460177
8048	0	0.12903225806451613	G	A	155	157	20	20	0	135	1	134	c	FALSE	0	0.9523809523809523	0
8050	0	0.056	G	T	125	126	7	7	0	118	11	107	c	FALSE	0	0.3888888888888889	0
8097	0	0.03508771929824561	C	T	285	285	10	0	10	275	180	95	c	FALSE	0	0	0.09523809523809523
8105	0	0.05389221556886228	C	T	668	669	36	26	10	631	380	251	c	TRUE	1	0.06403940886699508	0.038314176245210725
8108	0	0.04885057471264368	A	G	348	358	17	17	0	328	104	224	c	FALSE	0	0.14049586776859505	0
8124	0	0.032989690721649485	A	G	485	493	16	16	0	469	179	290	c	FALSE	0	0.08205128205128205	0
8185	0	0.060240963855421686	A	G	166	166	10	0	10	155	101	54	c	FALSE	0	0	0.15625
9200	0	0.03991130820399113	G	A	902	905	36	30	6	866	602	264	c	TRUE	1	0.04746835443037975	0.022222222222222223
9225	0	0.12040133779264214	C	T	897	897	108	66	42	789	251	538	c	TRUE	1	0.2082018927444795	0.07241379310344828
9242	0	0.09392265193370165	T	C	724	727	68	30	38	655	453	202	c	TRUE	1	0.062111801242236024	0.15833333333333333
9272	0	0.08365384615384615	C	T	1040	1040	87	44	43	953	446	507	c	TRUE	1	0.08979591836734693	0.07818181818181819
9277	0	0.04092071611253197	C	T	782	782	32	0	32	750	653	97	c	FALSE	0	0	0.24806201550387597
9296	0	0.13126491646778043	T	C	838	838	110	63	47	726	129	597	c	TRUE	1	0.328125	0.07298136645962733
9344	0	0.034375	G	A	320	331	11	6	5	309	6	303	c	FALSE	0	0.5	0.016233766233766232
9758	0	0.044374009508716325	A	G	631	631	28	4	24	596	132	464	c	TRUE	1	0.029411764705882353	0.04918032786885246
9818	0	0.22083333333333333	G	A	240	274	53	53	0	187	5	182	c	FALSE	0	0.9137931034482759	0
9834	0	0.050505050505050504	G	A	198	202	10	10	0	187	120	67	c	FALSE	0	0.07692307692307693	0
9887	0	0.0627763041556145	C	T	1131	1132	71	41	30	1060	477	583	c	TRUE	1	0.07915057915057915	0.048939641109298535
9899	0	0.18316831683168316	A	G	202	221	37	31	6	164	76	88	c	TRUE	1	0.2897196261682243	0.06382978723404255
9928	0	0.04332129963898917	C	T	277	284	12	0	12	262	137	125	c	FALSE	0	0	0.08759124087591241
9934	0	0.05191256830601093	T	C	366	382	19	1	18	344	123	221	c	FALSE	0	0.008064516129032258	0.07531380753138076
9994	0	0.03857566765578635	T	C	1348	1365	52	0	52	1296	752	544	c	FALSE	0	0	0.087248322147651
10193	0	0.05465587044534413	A	G	494	495	27	6	21	467	241	226	c	FALSE	0	0.024291497975708502	0.08502024291497975
10198	0	0.10638297872340426	G	A	188	192	20	2	18	168	25	143	c	FALSE	0	0.07407407407407407	0.11180124223602485
10217	0	0.07850707850707851	A	G	777	779	61	35	26	714	447	267	c	TRUE	1	0.07261410788381743	0.08873720136518772
10226	0	0.06896551724137931	A	G	174	178	12	12	0	162	116	46	c	FALSE	0	0.09375	0
10281	0	0.1015625	G	A	1152	1152	117	60	57	1032	562	470	c	TRUE	1	0.09646302250803858	0.10815939278937381
10286	0	0.13135593220338984	C	T	472	478	62	44	18	409	201	208	c	TRUE	1	0.17959183673469387	0.07964601769911504
10310	0	0.04040404040404041	G	T	297	298	12	12	0	283	16	267	c	FALSE	0	0.42857142857142855	0
10314	0	0.046413502109704644	A	G	948	949	44	32	12	904	450	454	c	TRUE	1	0.06639004149377593	0.02575107296137339
10319	0	0.06857142857142857	C	T	700	701	48	6	42	650	598	52	c	FALSE	0	0.009933774834437087	0.44680851063829785
10324	0	0.06471816283924843	T	C	479	525	31	0	31	447	334	113	c	FALSE	0	0	0.2152777777777778
10342	0	0.030395136778115502	A	T	329	333	10	10	0	317	223	94	c	FALSE	0	0.04291845493562232	0
10349	0	0.13195876288659794	T	C	485	487	64	36	28	419	152	267	c	TRUE	1	0.19148936170212766	0.09491525423728814
10360	0	0.059670781893004114	C	T	486	487	29	1	28	457	277	180	c	FALSE	0	0.0035971223021582736	0.1346153846153846
10361	0	0.12134831460674157	T	C	445	465	54	26	28	391	249	142	c	TRUE	1	0.09454545454545454	0.16470588235294117
10376	0	0.10734463276836158	G	A	531	531	57	33	24	473	387	86	c	TRUE	1	0.07857142857142857	0.21818181818181817
